{wi}reveal{/wi} a secret	verb
Lack of sufficient support was {wi}fatal{/wi} to his campaign.	adjective
Lack of sufficient support was {wi}fatal{/wi} to his campaign.	adjective
a {wi}fatal{/wi} crash	adjective
the {wi}fatal{/wi} flaw in this dazzling woman: a total lack of taste	adjective
a {wi}fatal{/wi} disease	adjective
scissors with {wi}blunt{/wi} ends	adjective
She tends to be {wi}blunt{/wi}.	adjective
was hit over the head with a {wi}blunt{/wi} instrument	adjective
a blood vessel that {wi}collapsed{/wi}	verb
… his case had {wi}collapsed{/wi} in a mass of legal wreckage …	verb
a {wi}hefty{/wi} football player	adjective
{it}gripped{/it} the door handle	verb
a story that {wi}grips{/wi} the reader	verb
She thought about retiring, but she finally decided to {it}stay on{/it} for a few more years.	phrasal verb
I have to {it}stay on{/it} the antibiotics for a full two weeks.	phrasal verb
After she graduated, she {it}stayed on{/it} at the college, working in the alumnae office.	phrasal verb
{wi}bright{/wi} lights	adjective
{wi}brightest{/wi} star of the opera	adjective
{wi}bright{/wi} eyes	adjective
the planets in their {wi}courses{/wi}	noun
a {wi}vocational{/wi} school	adjective
{wi}deserves{/wi} another chance	verb
a mirror {wi}reflects{/wi} light	verb
the clouds were {wi}reflected{/wi} in the water	verb
{wi}seesaw{/wi} between two activities	verb
impostors that {wi}haunt{/wi} the official in foreign ports	verb
spends a lot of time {wi}haunting{/wi} bookstores	verb
problems we ignore now will come back to {wi}haunt{/wi} us	verb
an {wi}exploited{/wi} resource	adjective
He dedicated his life to improving the wages and working conditions of one of the nation's poorest and most {wi}exploited{/wi} groups of workers …	adjective
Pescatarians … are forgetting the fact that fish are the most {wi}exploited{/wi} species on our planet.	adjective
desk-{it}bound{/it}	adjective
duty-{it}bound{/it}	adjective
She {it}accompanied{/it} me to the store.	verb
He will be {wi}accompanying{/wi} her on the piano.	verb
everything in neat {wi}arrangement{/wi}	noun
a blood vessel that {wi}collapsed{/wi}	verb
… his case had {wi}collapsed{/wi} in a mass of legal wreckage …	verb
a movement now regarded as a {wi}footnote{/wi} to architectural history	noun
here since the {wi}foundation{/wi} of the school	noun
the {wi}foundations{/wi} of geometry	noun
the dramatic flourishes which are the {wi}hallmark{/wi} of the trial lawyer	noun
a vegetable {wi}plot{/wi}	noun
couldn't {wi}reach{/wi} the apple	verb
a {wi}wide{/wi} area	adjective
3 feet {wi}wide{/wi}	adjective
{wi}figured{/wi} muslin	adjective
{wi}figured{/wi} wood	adjective
Employees are looking for some {wi}clarity{/wi} {gloss}=understanding{/gloss} on the company's new policies.	noun
Employees are looking for some {wi}clarity{/wi} {gloss}=understanding{/gloss} on the company's new policies.	noun
Mr. Darlington writes with wit and {wi}clarity{/wi}.	noun
The next time you hire a {wi}sitter{/wi} {gloss}=babysitter{/gloss}, remind your daughter what happened the last time and let her know that you are only a phone call away.	noun
The next time you hire a {wi}sitter{/wi} {gloss}=babysitter{/gloss}, remind your daughter what happened the last time and let her know that you are only a phone call away.	noun
a {wi}sitter{/wi} for enemy submarines	noun
her {wi}habit{/wi} of taking a morning walk	noun
got up early from force of {wi}habit{/wi}	noun
a {wi}terse{/wi} summary	adjective
dismissed me with a {wi}terse{/wi} "no"	adjective
scenes {wi}etched{/wi} in our minds	verb
the {wi}machinery{/wi} of government	noun
her stunned {wi}reaction{/wi} to the news	noun
{wi}attack{/wi} an enemy fortification	verb
a politician verbally {wi}attacked{/wi} by critics	verb
a dictionary {wi}belongs{/wi} in every home	verb
{wi}repay{/wi} a loan	verb
a {wi}foray{/wi} into enemy territory	noun
the novelist's {wi}foray{/wi} into nonfiction	noun
attempted sneak and surprise {wi}forays{/wi}	noun
{wi}loosened{/wi} his tie	verb
money {wi}earmarked{/wi} for education	verb
the height, {wi}breadth{/wi}, and depth of each piece of furniture	noun
begin with a {wi}breadth{/wi} of silk	noun
nailed {wi}boards{/wi} over the windows	noun
Pin the photo to the {wi}board{/wi}.	noun
made my {wi}position{/wi} on the issue clear	noun
{wi}defend{/wi} the castle from invaders	verb
which God {wi}defend{/wi} that I should wring from him	verb
measured by the {wi}yardstick{/wi} of her first book	noun
a {wi}decrepit{/wi} old man	adjective
a {wi}decrepit{/wi} school bus	adjective
the {wi}effete{/wi} monarchies … of feudal Europe	adjective
a hearty {wi}constitution{/wi}	noun
doesn't {wi}allow{/wi} people to smoke in his home	verb
{wi}allow{/wi} an hour for lunch	verb
The criminals avoided/eluded/escaped {wi}capture{/wi}.	noun
… authorities increased the reward for information leading to his {wi}capture{/wi} …	noun
{wi}argue{/wi} for a new policy	verb
They're always {wi}arguing{/wi} about money.	verb
always felt {wi}inferior{/wi} to his older brother	adjective
{wi}reinforce{/wi} levees	verb
{wi}reinforce{/wi} our troops	verb
{wi}reinforce{/wi} the elbows of a jacket	verb
At length the cat steps {wi}halfway{/wi} out the door, showing his spotted brown coat and the stripes on his legs.	adverb
{wi}bend{/wi} a bow	verb
{wi}bend{/wi} a pipe	verb
… Grand Cayman offers a {wi}plethora{/wi} of bustling restaurants, ritzy resorts and comfortable condos …	noun
… a world whose credibility is threatened by the meaningless {wi}plethora{/wi} of material goods it goes on producing.	noun
She still {it}talks about{/it} your wedding and how perfect it was.	phrasal verb
We were {it}talking about{/it} last night's game.	phrasal verb
a {wi}foray{/wi} into enemy territory	noun
the novelist's {wi}foray{/wi} into nonfiction	noun
attempted sneak and surprise {wi}forays{/wi}	noun
a {wi}sweaty{/wi} day	adjective
{wi}sweaty{/wi} socks	adjective
{wi}sweaty{/wi} work	adjective
The {wi}takeaway{/wi} is clear: cats are a growing environmental concern because they are driving down some native bird populations …	noun
One of the main {wi}takeaways{/wi} stressed by the panelists was that social media is about conversation, not just dissemination.	noun
{wi}salubrious{/wi} habits	adjective
"… You have both always had large private means, and have never had the {wi}wholesome{/wi} discipline of work."	adjective
his {wi}wholesome{/wi} good looks	adjective
{wi}uninhibited{/wi} exuberance	adjective
a festive {wi}uninhibited{/wi} party	adjective
in another {wi}incarnation{/wi} he might be a first vice-president	noun
a very {wi}odd{/wi} way to show gratitude	adjective
worked at {wi}odd{/wi} jobs	adjective
{wi}diminish{/wi} an army's strength	verb
{wi}diminish{/wi} a rival's accomplishments	verb
His role in the company was {wi}diminished{/wi}.	verb
a political {wi}minefield{/wi}	noun
was {wi}bludgeoned{/wi} to death	verb
mental {wi}bludgeoning{/wi}	verb
{wi}reassuring{/wi} news	adjective
a {wi}reassuring{/wi} smile/response	adjective
This is a side of her {wi}character{/wi} that few people have seen.	noun
a {wi}character{/wi} in a play	noun
granite stones {wi}harsh{/wi} with lichen	adjective
{wi}harsh{/wi} colors	adjective
{it}broke{/it} a plate	verb
{wi}break{/wi} the law	verb
{it}Break{/it} the chocolate bar in half.	verb
They were {wi}curious{/wi} as to who won the game.	adjective
a {wi}curious{/wi} coincidence	adjective
The cat was {wi}curious{/wi} about its new environment.	adjective
a political {wi}minefield{/wi}	noun
a {it}tree-lined{/it} street	adjective
The moon {wi}highlighted{/wi} the tree tops.	verb
The speech will {wi}highlight{/wi} the need for education reform.	verb
Outdoor lighting is an important part of any garden design, providing ambiance and {wi}highlighting{/wi} key features like plants, water features, and walkways.	verb
a {wi}brilliant{/wi} light	adjective
a {wi}brilliant{/wi} example	adjective
{it}buried{/it} their pet rabbit in the backyard	verb
a dog {it}burying{/it} a bone	verb
was {it}buried{/it} with full military honors	verb
{wi}maintain{/wi} machinery	verb
{wi}maintain{/wi} a position	verb
an {wi}absorbing{/wi} novel	adjective
an {wi}army{/wi} of birds	noun
a wine {wi}cave{/wi}	noun
{wi}put{/wi} the book on the table	verb
{wi}put{/wi} traitors to death	verb
kept her room {wi}neat{/wi}	adjective
a {wi}neat{/wi} trick	adjective
{wi}reckon{/wi} the days till Christmas	verb
{wi}fantastic{/wi} works of art	adjective
She {wi}aims{/wi} to win.	verb
{it}Aim{/it} carefully before shooting.	verb
{wi}replace{/wi} cards in a file	verb
{wi}reverse{/wi} order	adjective
sailing toward the {wi}horizon{/wi}	noun
{wi}arrange{/wi} flowers in a vase	verb
{it}arranged{/it} a reception for the visitor	verb
{wi}arrange{/wi} cards alphabetically	verb
a plumbing {wi}fixture{/wi}	noun
Fire {it}consumed{/it} several buildings.	verb
{it}consumed{/it} his inheritance on luxuries	verb
The {wi}conflagration{/wi} between the two countries lasted for ten years.	noun
The {wi}conflagration{/wi} destroyed the warehouses.	noun
{wi}discordant{/wi} opinions	adjective
a {wi}discordant{/wi} tone	adjective
{it}lost{/it} his glove	verb
protesters were {wi}chanting{/wi} outside	verb
was in {wi}wretched{/wi} health	adjective
will {wi}ruin{/wi} your chances of promotion	verb
{wi}admits{/wi} no possibility of misunderstanding	verb
an open window had {it}admitted{/it} rain	verb
his sentences and phrases are too often {wi}pedestrian{/wi}, commonplace, and flat	adjective
{wi}pedestrian{/wi} traffic	adjective
"To Thee I do {wi}commend{/wi} my watchful soul / Ere I let fall the windows of mine eyes."	verb
Your proposal has much to {wi}commend{/wi} it.	verb
… she {wi}habited{/wi} herself in a peculiarly becoming dress of white linen …	verb
It is the nature of such pedantry to {wi}habit{/wi} itself in a harsh and crabbed style.	verb
… its efforts were supported by the cavalry which … compensated for the infantry's lack of {wi}mobility{/wi}.	noun
A large body of academic research shows that inequality and lack of social {wi}mobility{/wi} hurt not just those at the bottom; they hurt everyone.	noun
… it becomes cost-effective and socially advantageous to provide urban {wi}mobility{/wi} by means of metros: urban rail mass transit systems on exclusive rights-of-way.	noun
a {wi}swift{/wi} runner	adjective
a {wi}swift{/wi} transition	adjective
{wi}encapsulated{/wi} water bacteria	adjective
She taught him how to sing {wi}harmony{/wi}.	noun
a painting exhibiting {wi}harmony{/wi} of color and line	noun
She glanced {wi}backward{/wi} over her shoulder.	adverb
Count {wi}backward{/wi} from 10.	adverb
a suspicion that she scarcely dared to {wi}hint{/wi}	verb
She's been {wi}gifted{/wi} with a beautiful voice.	verb
It makes an excellent choice whether you're {wi}gifting{/wi} one bottle for the honeymoon or a case to be savored for years, or even decades, to come.	verb
was {wi}recalled{/wi} to active duty	verb
her performance is the film's {wi}redeeming{/wi} feature	adjective
sly remarks to {wi}pique{/wi} their curiosity	verb
what {wi}piques{/wi} linguistic conservatives	verb
{wi}jousting{/wi} debaters	verb
{wi}pocketed{/wi} the change	verb
a steep rocky {wi}peak{/wi}	noun
The cap's {wi}peak{/wi} shades his eyes.	noun
{it}gripped{/it} the door handle	verb
a story that {wi}grips{/wi} the reader	verb
the {wi}accession{/wi} of a new queen	noun
the museum's latest {wi}accessions{/wi}	noun
a politician's {wi}accession{/wi} to power	noun
{it}flopped{/it} into the chair	verb
hopes to go to {it}Heaven{/it} when she dies	noun
a {wi}hardworking{/wi} young woman	adjective
{ldquo}Our students have to be very {wi}hardworking{/wi} and committed. They put in long hours. …{rdquo}	adjective
a shy and {wi}withdrawn{/wi} child	adjective
{wi}fruitful{/wi} soil	adjective
a {wi}fruitful{/wi} discussion	adjective
{it}exchanging{/it} future security for immediate pleasure	verb
a {wi}dogged{/wi} competitor	adjective
{wi}dogged{/wi} devotion	adjective
didn't {wi}exercise{/wi} good judgment	verb
{wi}exercise{/wi} a muscle	verb
got no {wi}farther{/wi} than the first page	adverb
see to it that I do not have to act any {wi}farther{/wi} in the matter	adverb
nothing could be {wi}farther{/wi} from the truth	adverb
Sid snored on. Tom was {wi}aggravated{/wi}. He said, "Sid, Sid!" and shook him.	adjective
{wi}aggravated{/wi} manslaughter	adjective
The maid sounded very {wi}aggravated{/wi}.	adjective
an {wi}evil{/wi} impulse	adjective
{wi}brotherly{/wi} love	adjective
kept a tight {wi}rein{/wi} on the proceedings	noun
{wi}cast{/wi} a fishing lure	verb
{wi}cast{/wi} dice	verb
We led out more rope and {wi}fixed{/wi} it in place up steeper snow.	verb
{wi}fixes{/wi} his eyes on the horizon	verb
the tree always {wi}yields{/wi} good fruit	verb
{wi}buoy{/wi} an anchor	verb
a raft {wi}buoyed{/wi} by empty oil drums	verb
a {wi}dramatic{/wi} actor	adjective
a {wi}dramatic{/wi} story	adjective
… has earned three Oscar nominations for his {wi}dramatic{/wi} roles …	adjective
{wi}controlled{/wi} drugs	adjective
{wi}conduct{/wi} a class	verb
{wi}conduct{/wi} a class	verb
{wi}conduct{/wi} an opera	verb
{wi}conduct{/wi} an experiment	verb
{wi}conducted{/wi} herself in a professional manner	verb
{wi}conduct{/wi} a business	verb
Storm clouds {wi}loomed{/wi} on the horizon.	verb
deficits {wi}loomed{/wi} large	verb
{it}fading{/it} flowers	verb
The fabrics {it}faded{/it} in the strong sunshine.	verb
Our {wi}narcissistic{/wi} culture has turned us into a nation of body-image "junkies" using everything in our power to carve, reshape, remold, and recast our bodies' natural shapes and processes so that they are better fitted to our desires.	adjective
Our {wi}narcissistic{/wi} culture has turned us into a nation of body-image "junkies" using everything in our power to carve, reshape, remold, and recast our bodies' natural shapes and processes so that they are better fitted to our desires.	adjective
He was a very {wi}narcissistic{/wi} man, not too concerned with the world.	adjective
But when a mother's {wi}narcissistic{/wi} needs are so great that she cannot relate to her child as he really is, she loves her child as a self-object—that is, as someone put on this earth to meet her needs.	adjective
a prose style {it}stripped{/it} to the bones	verb
{wi}threadbare{/wi} clothes	adjective
{wi}handy{/wi} with a hammer as well as with a paintbrush	adjective
{it}struggling{/it} with the problem	verb
{it}struggled{/it} through the high grass	verb
Paella, once the {wi}lowly{/wi} meal of farmers … has indeed evolved into a very sumptuous one-dish meal …	adjective
a {wi}lowly{/wi} task	adjective
It's easy to overlook the {wi}lowly{/wi} alphabet book.	adjective
bushes {wi}sprawling{/wi} along the road	verb
an actor currently {wi}starring{/wi} in a hit Broadway show	verb
In the fall of 1925, Elkins {wi}starred{/wi} on the gridiron …	verb
She had a {phrase}starring role{/phrase} in his latest film.	verb
{wi}troubled{/wi} feelings about the decision	adjective
our {wi}troubled{/wi} cities	adjective
The composer {it}orchestrated{/it} the music for the symphony orchestra.	verb
{it}orchestrated{/it} preparations for the banquet	verb
{wi}defeated{/wi} their archrivals in the championship game	verb
{wi}defeat{/wi} a hope	verb
The bill was {wi}defeated{/wi} in the Senate.	verb
{wi}retune{/wi} an engine	verb
a guitar/string that constantly needs to be {wi}retuned{/wi}	verb
{wi}succumb{/wi} to temptation	verb
{wi}green{/wi} fields	adjective
a {wi}short{/wi} vacation	adjective
{wi}boosted{/wi} him up over the fence	verb
plans to {wi}boost{/wi} production	verb
{wi}dazzling{/wi} lights	adjective
a {wi}dazzling{/wi} display of talent	adjective
{wi}mix{/wi} a drink at the bar	verb
wore a rabbit's foot as a good-luck {wi}charm{/wi}	noun
a remote region {wi}accessible{/wi} by rail	adjective
information that should be {wi}accessible{/wi} to everyone	adjective
fashions at {wi}accessible{/wi} prices	adjective
She {wi}aims{/wi} to win.	verb
{it}Aim{/it} carefully before shooting.	verb
Every spring the National Football League conducts that most cherished of American rituals, the college draft. A couple of months before the event, prospective players show off their abilities in an athletic audition known as the {wi}combine{/wi}.	noun
… Grumman Corp. lost the advanced tactical aircraft contract to the {wi}combine{/wi} of McDonnell Douglas and General Dynamics.	noun
{it}exploded{/it} in anger	verb
{wi}hunt{/wi} buffalo	verb
{wi}hunted{/wi} the escapees	verb
a catalyst {wi}poison{/wi}	noun
{wi}dismiss{/wi} the visitors	verb
He was {wi}dismissed{/wi} {gloss}=fired{/gloss} from his job.	verb
Class is {wi}dismissed{/wi}.	verb
an insatiable {wi}appetite{/wi} for work	noun
He has a hearty {wi}appetite{/wi}.	noun
He was {wi}hit{/wi} by a car.	verb
The tank was {wi}hit{/wi} by enemy fire.	verb
His mom told him to stop {it}hitting{/it} his sister.	verb
She accidentally {wi}hit{/wi} her head getting into the car.	verb
a rational understanding of the laws of nature can {wi}quench{/wi} impossible desires	verb
a rational understanding of the laws of nature can {wi}quench{/wi} impossible desires	verb
{it}drying{/it} her hair	verb
{wi}lascivious{/wi} acts/thoughts	adjective
arrested for lewd and {wi}lascivious{/wi} assault	adjective
{wi}swirling{/wi} water	verb
{wi}oily{/wi} rags	adjective
{wi}laces{/wi} her fingers behind her head	verb
a {wi}ritual{/wi} dance	adjective
{wi}ritual{/wi} purity	adjective
The {wi}novices{/wi} spend part of each day in prayer and meditation.	noun
{wi}stressing{/wi} the equipment	verb
this traffic is {wi}stressing{/wi} me out	verb
a man of dignified {wi}bearing{/wi}	noun
a woman past {wi}bearing{/wi}	noun
… a confident and cheerful {wi}bearing{/wi}.	noun
fans {wi}lingered{/wi} outside the door	verb
{wi}lingering{/wi} doubts	verb
a {wi}ticklish{/wi} subject	adjective
The {wi}novices{/wi} spend part of each day in prayer and meditation.	noun
a {wi}venerable{/wi} jazz musician	adjective
encouraged by the {wi}venerable{/wi} doctor's head-nodding	adjective
{wi}dictate{/wi} for the stenographer	verb
resents being {it}dictated{/it} to	verb
{wi}plan{/wi} a new layout	verb
{it}planned{/it} their escape	verb
Some jurisdictions are so {wi}overwhelmed{/wi} that they are experimenting with routing school-children into specially designed courts that would keep first-time offenders from being saddled with an arrest record.	adjective
When he first appeared in full regalia, I was {wi}overwhelmed{/wi}.	adjective
Only three Coast Guard rescue helicopters had managed to get into the air, and each was already {wi}overwhelmed{/wi} by dozens of calls for help.	adjective
{wi}explain{/wi} the secret of your success	verb
unable to {wi}explain{/wi} his strange conduct	verb
{wi}arrange{/wi} flowers in a vase	verb
{it}arranged{/it} a reception for the visitor	verb
{wi}arrange{/wi} cards alphabetically	verb
The museum {wi}attracts{/wi} visitors.	verb
The museum {wi}attracts{/wi} visitors.	verb
an organization {wi}staffed{/wi} by volunteers	verb
{wi}pointing{/wi} a pencil with a knife	verb
{wi}stretched{/wi} out her arms	verb
a {wi}querulous{/wi} voice	adjective
St. Andrew is {wi}commemorated{/wi} on November 30.	verb
{wi}commemorate{/wi} an anniversary	verb
an {wi}unruly{/wi} crowd	adjective
a mane of {wi}unruly{/wi} hair	adjective
a {wi}cacophony{/wi} of color	noun
{wi}heroic{/wi} legends	adjective
It was a {wi}heroic{/wi} decision.	adjective
the {wi}heroic{/wi} age	adjective
pride{it}ful{/it}	adjective suffix
peace{it}ful{/it}	adjective suffix
{wi}wheeled{/wi} vehicles	adjective
{wi}wheeled{/wi} traffic	adjective
Much as we try, we can't stop {wi}humanizing{/wi} our horses.	verb
Lincoln forged a new lean language to {wi}humanize{/wi} and redeem the first modern war.	verb
tried to {wi}gather{/wi} a crowd	verb
{wi}gather{/wi} flowers	verb
{wi}gathered{/wi} firewood	verb
people of {wi}slender{/wi} means	adjective
{wi}bold{/wi} settlers on some foreign shore	adjective
punishing a {wi}bold{/wi} child for talking back	adjective
The price of the stock {it}declined{/it}.	verb
his health {it}declined{/it}	verb
{wi}astronomical{/wi} observations	adjective
{wi}astronomical{/wi} numbers	adjective
a {wi}defrocked{/wi} priest	verb
an advertising {wi}blitz{/wi}	noun
constructed a {wi}mythical{/wi} all-star team	adjective
a {wi}tragic{/wi} mistake	adjective
the {wi}tragic{/wi} significance of the atomic bomb	adjective
a civil rights {wi}icon{/wi}	noun
Rosie the Riveter, a WWII [World War II] cultural {wi}icon{/wi} with her blue jumpsuit and red bandana, represented the women who went to work at manufacturing hubs across the nation …	noun
an actor and fashion {wi}icon{/wi}	noun
The king {it}graced{/it} him with the rank of a knight.	verb
graveled walks {it}graced{/it} with statues	verb
{wi}transpose{/wi} letters to change the spelling	verb
Each {wi}facet{/wi} of the problem requires careful attention.	noun
a dormitory with a {wi}shared{/wi} living area	adjective
Despite the {wi}shared{/wi} memory, the PC performed relatively well …	adjective
{wi}shared{/wi} equity	adjective
Charlie Stuart represents a new breed of motorcyclists who are erasing the {wi}stereotypical{/wi} black-leather-jacket, tough-guy image that plagued motorcyclists since the violent Hollywood productions of the Fifties.	adjective
His book concedes that progress has been made in a sheerly numerical sense, but it argues that overall the black presence on television has been an endless recycling of a passel of injuriously {wi}stereotypical{/wi} images.	adjective
{wi}throw{/wi} a baseball	verb
{it}threw{/it} his opponent	verb
a {wi}revealing{/wi} confession	adjective
a {wi}revealing{/wi} halter top	adjective
{wi}uncover{/wi} the truth	verb
an {wi}attractive{/wi} smile	adjective
{wi}attractive{/wi} forces between molecules	adjective
at {wi}close{/wi} range	adjective
{wi}close{/wi} friends	adjective
{wi}close{/wi} to my birthday	adjective
a {wi}directed{/wi} reading program for students	adjective
{wi}directed{/wi} line segment	adjective
bloodied but {wi}unbowed{/wi}	adjective
{wi}disguised{/wi} herself in a wig and glasses	verb
{wi}mix{/wi} a drink at the bar	verb
{wi}dismiss{/wi} the visitors	verb
He was {wi}dismissed{/wi} {gloss}=fired{/gloss} from his job.	verb
Class is {wi}dismissed{/wi}.	verb
{wi}defuse{/wi} a crisis	verb
{wi}thrust{/wi} a dagger into his heart	verb
{wi}leap{/wi} over a fence	verb
the difficult {wi}leap{/wi} from college to the workplace	verb
a fish {wi}leaps{/wi} out of the water	verb
{wi}discovering{/wi} himself … as her adoring and magnanimous lover	verb
{wi}discover{/wi} the solution	verb
{wi}reveal{/wi} a secret	verb
The book {wi}deals{/wi} with education.	verb
{wi}deal{/wi} with an offender	verb
a lawyer who {wi}deals{/wi} with real estate law	verb
is said to {wi}derive{/wi} its name from a Native American word meaning "wild onion"	verb
what was {it}derived{/it} from their observations	verb
a complex {wi}labyrinth{/wi} of tunnels and chambers	noun
a {wi}labyrinth{/wi} of swamps and channels	noun
{wi}violate{/wi} the law	verb
{it}misused{/it} his talents	verb
… their prisoner had the heavy task of receiving their insolence as wit, answering their insults with good-humour, and withholding from them the opportunity which they sought of engaging him in a quarrel, that they might have a pretence for {wi}misusing{/wi} him.	verb
a word that is frequently {it}misused{/it}	verb
one military force {it}opposed{/it} to another	verb
{wi}oppose{/wi} the enemy	verb
concreteness as {it}opposed{/it} to abstraction	verb
Wallace {wi}asserted{/wi} control early—shutting down both candidates when they tried to talk over one another, and shushing the audience when it reacted too audibly.	verb
The suspect continued to {wi}assert{/wi} his innocence.	verb
He wished to vindicate himself in some way, to {wi}assert{/wi} his manhood.	verb
{wi}borderline{/wi} hypertension	adjective
a {wi}borderline{/wi} state between waking and sleeping	adjective
a {wi}borderline{/wi} town	adjective
an unusual {wi}juxtaposition{/wi} of colors	noun
contrasting shapes placed in {wi}juxtaposition{/wi} to each other	noun
free trade {wi}versus{/wi} protection	preposition
a dictator who {wi}banishes{/wi} anyone who opposes him	verb
He was {wi}banished{/wi} from court.	verb
granite stones {wi}harsh{/wi} with lichen	adjective
{wi}harsh{/wi} colors	adjective
{wi}refer{/wi} a patient to a specialist	verb
studied his own life … with a shrewd and {wi}humorous{/wi} eye	adjective
{wi}humorous{/wi} stories	adjective
shared a {wi}humorous{/wi} anecdote	adjective
butterflies {wi}fluttering{/wi} among the flowers	verb
a sail {wi}fluttering{/wi} in the wind	verb
{wi}hollow{/wi} cheeks	adjective
a {wi}hollow{/wi} tree	adjective
selfishness that had a {wi}gloss{/wi} of humanitarianism about it	noun
The soldiers {wi}crawled{/wi} forward on their bellies.	verb
The baby {wi}crawled{/wi} toward her mother.	verb
traffic {wi}crawling{/wi} along at 10 miles an hour	verb
{wi}bluffed{/wi} them into surrendering	verb
was {wi}bluffed{/wi} out of a winning hand	verb
Her own childhood had been made miserable by {wi}bullying{/wi} …	noun
… underestimates the plain meanness behind the pleasure people take in {wi}bullying{/wi}.	noun
can't tell you the answer but can give you a {wi}hint{/wi}	noun
had been dropping {wi}hints{/wi} that he would like to be invited	noun
gave only a {wi}hint{/wi} of what was to come	noun
stared in {wi}blank{/wi} dismay	adjective
their partnership was {it}dissolved{/it}	verb
their partnership was {it}dissolved{/it}	verb
do not {wi}dissolve{/wi} and deface the laws of charity	verb
{wi}dissolve{/wi} sugar in water	verb
{it}paid{/it} a teenager to mow his lawn	verb
{it}paid{/it} the pizza deliverer	verb
{wi}pay{/wi} wages	verb
a floral {wi}tribute{/wi}	noun
They were {wi}fighting{/wi} to stay awake.	verb
The soldiers {it}fought{/it} bravely.	verb
So far, I've had the {wi}common sense{/wi} not to tweet anything ghastly.	noun
The poker players learns that sometimes both science and {wi}common sense{/wi} are wrong. There is such a thing as absolute premonition of cards, a rock bottom surety of what will happen next.	noun
didn't {wi}exercise{/wi} good judgment	verb
{wi}exercise{/wi} a muscle	verb
an idea that {wi}appeals{/wi} to him	verb
We {wi}appealed{/wi} to them for help.	verb
{wi}define{/wi} a procedure	verb
{wi}define{/wi} a procedure	verb
whatever {wi}defines{/wi} us as human	verb
rigidly {it}defined{/it} property lines	verb
{wi}envisages{/wi} the slum as a hotbed of crime	verb
{wi}envisages{/wi} an entirely new system of education	verb
a river that {wi}arises{/wi} from two main sources	verb
Problems {wi}arise{/wi} when people try to avoid responsibility.	verb
He {wi}arose{/wi} from his chair.	verb
A conflict {wi}arose{/wi} because of a misunderstanding.	verb
{wi}adapt{/wi} the curriculum to students' needs	verb
{wi}enact{/wi} a role	verb
{wi}enact{/wi} a bill	verb
seemed to be talking {wi}uphill{/wi}	adverb
{wi}beaten{/wi} gold	adjective
{it}struggling{/it} with the problem	verb
{it}struggled{/it} through the high grass	verb
{wi}margin{/wi} up an account	verb
trying to {wi}undermine{/wi} his political rivals	verb
a plumbing {wi}fixture{/wi}	noun
{wi}boosted{/wi} him up over the fence	verb
plans to {wi}boost{/wi} production	verb
{wi}powerless{/wi} victims	adjective
was {wi}powerless{/wi} to help	adjective
a {wi}lighthearted{/wi} mood	adjective
they can be {wi}lighthearted{/wi} in the midst of misery	adjective
The pill left a {wi}bitter{/wi} taste in my mouth.	adjective
{wi}bitter{/wi} beer	adjective
liquid {wi}damps{/wi} out compass oscillations	verb
a {wi}recovering{/wi} alcoholic	adjective
a still-bookish {wi}recovering{/wi} academic with a tendency to live in his head	adjective
yellow leaves {wi}floated{/wi} down	verb
{wi}smothered{/wi} his rage	verb
health-care {wi}providers{/wi}	noun
an Internet {wi}provider{/wi}	noun
the dishes {wi}clattered{/wi} on the shelf	verb
{wi}drill{/wi} pupils in spelling	verb
{wi}stitched{/wi} a seam	verb
the boy {wi}stuffed{/wi} his pockets with candy	verb
{wi}stuffing{/wi} their heads with facts	verb
unable to pay off his {wi}debts{/wi}	noun
deeply in {wi}debt{/wi} to creditors	noun
owe them a {wi}debt{/wi} of gratitude	noun
the windows {it}rattled{/it} in the wind	verb
Her {wi}cure{/wi} was complete.	noun
{wi}leap{/wi} over a fence	verb
the difficult {wi}leap{/wi} from college to the workplace	verb
a fish {wi}leaps{/wi} out of the water	verb
had no {wi}clue{/wi} what he meant	noun
{wi}phases{/wi} of the moon	noun
the early {wi}phases{/wi} of her career	noun
{wi}prohibitive{/wi} costs	adjective
studied the French {wi}language{/wi}	noun
{wi}overturned{/wi} the vase	verb
the degree to which accident could {wi}overturn{/wi} the schemes of wise men	verb
{wi}musters{/wi} of goods for sale	noun
the project {wi}halted{/wi} for lack of funds	verb
{wi}contribute{/wi} money to a cause	verb
He {wi}contributed{/wi} several poems to the magazine.	verb
{wi}contributed{/wi} canned goods to the food drive	verb
{wi}tread{/wi} a path	verb
a positive {wi}outlook{/wi} on life	noun
{wi}feverish{/wi} excitement	adjective
{it}dodged{/it} through the crowd	verb
The ground was covered with a {wi}mantle{/wi} of leaves.	noun
{wi}felled{/wi} trees/timber	adjective
{wi}provoke{/wi} laughter	verb
{wi}unarmed{/wi} civilians	adjective
{wi}unarmed{/wi} robbery	adjective
{it}struck{/it} off through the brush	verb
cymbals {wi}clashed{/wi}	verb
where ignorant armies {wi}clash{/wi} by night	verb
a {wi}diffuse{/wi} report from the scene of the earthquake	adjective
{wi}diffuse{/wi} lighting	adjective
{it}swept{/it} the crumbs from the table	verb
{wi}construct{/wi} a bridge	verb
{wi}Construct{/wi} a regular hexagon with sides 3 inches long.	verb
{wi}construct{/wi} a plan	verb
The batteries provide enough power for up to five hours of {wi}continuous{/wi} use.	adjective
at {wi}close{/wi} range	adjective
{wi}close{/wi} friends	adjective
{wi}close{/wi} to my birthday	adjective
{wi}infuse{/wi} the team with confidence	verb
the sense of purpose that {it}infuses{/it} scientific research	verb
{wi}thrust{/wi} a dagger into his heart	verb
{wi}crested{/wi} the hill and looked around	verb
a {wi}unidirectional{/wi} microphone	adjective
The buccaneer on the {wi}wave{/wi} might relinquish his calling and become … a man of probity and piety on land …	noun
The sea was open to them, and they achieved their victories on the briny {wi}wave{/wi}.	noun
a mirror {wi}reflects{/wi} light	verb
the clouds were {wi}reflected{/wi} in the water	verb
"We have not the strength with which to fight this man; we must … win, if win we can, by {wi}craft{/wi}."	noun
the carpenter's {wi}craft{/wi}	noun
{wi}destroyed{/wi} the files	verb
{wi}destroy{/wi} an injured horse	verb
their reputation was {wi}destroyed{/wi}	verb
The missing boy was returned to his home {wi}unharmed{/wi}.	adjective
Film and paint companies are using computers to design dyes that will survive sunlight but leave humans {wi}unharmed{/wi}.	adjective
the troops {wi}embarked{/wi} at noon	verb
{wi}embarked{/wi} on a new career	verb
She was {wi}declared{/wi} the rightful heir to the throne.	verb
publicly {it}declared{/it} her opposition to the plan	verb
{wi}defuse{/wi} a crisis	verb
{wi}marginal{/wi} notes	adjective
{wi}hostile{/wi} to new ideas	adjective
{wi}hostile{/wi} to new ideas	adjective
{wi}hostile{/wi} fire	adjective
a {wi}hostile{/wi} witness	adjective
the {wi}soft{/wi} influences of home	adjective
a {wi}soft{/wi} job	adjective
{it}gazed{/it} out the window at the snow	verb
a {wi}whining{/wi} howl	adjective
They [scientists] think that … joyful people outlive their bilious, {wi}whining{/wi} counterparts.	adjective
… a coil of steel spins through a {wi}whining{/wi} mass of machinery the size of a small two-story house.	adjective
{wi}gulp{/wi} down a sob	verb
{wi}wiry{/wi} stems	adjective
the {wi}wiry{/wi} figure of a long-distance runner	adjective
{wi}queasy{/wi} motion	adjective
{it}mopped{/it} his brow with a handkerchief	verb
{wi}mop{/wi} the floors	verb
{it}repelled{/it} the insinuation	verb
a {it}well-connected{/it} lawyer	adjective
a {wi}substantial{/wi} meal	adjective
{wi}qualified{/wi} approval	adjective
an {wi}irresistible{/wi} attraction	adjective
He {wi}leaned{/wi} back in his chair.	verb
… preferred not to {wi}lean{/wi} on his father in building a career.	verb
Something about the smile {wi}lurking{/wi} on Malfoy's face during the next week made Harry, Ron, and Hermione very nervous.	verb
Something about the smile {wi}lurking{/wi} on Malfoy's face during the next week made Harry, Ron, and Hermione very nervous.	verb
someone out there {wi}lurking{/wi} in the shadows	verb
{wi}throw{/wi} a baseball	verb
{it}threw{/it} his opponent	verb
{wi}assiduous{/wi} planning	adjective
an {wi}assiduous{/wi} book collector	adjective
comfortably {wi}fixed{/wi}	adjective
a {wi}smart{/wi} young student	adjective
a {wi}smart{/wi} comedy/sitcom	adjective
a {wi}smart{/wi} decision/investment/idea	adjective
of French {wi}descent{/wi}	noun
begin our {wi}descent{/wi} down the mountain	noun
patrilineal {wi}descent{/wi}	noun
an advertising {wi}juggernaut{/wi}	noun
a political {wi}juggernaut{/wi}	noun
… his overly erect posture and {wi}overemphatic{/wi} diction make him come off like an enraged headwaiter.	adjective
… the … posturing and {wi}overemphatic{/wi} gesturing needed to reach the balcony in theater …	adjective
People believe that there is a {wi}curse{/wi} on the house.	noun
In an antechamber, his lieutenants suddenly heard the shattering of glass and angry {wi}curses{/wi}.	noun
{wi}sort{/wi} apples	verb
{wi}sort{/wi} mail	verb
agreed, but with {wi}reservations{/wi}	noun
a {wi}tasty{/wi} meal	adjective
Bad weather forced the {wi}diversion{/wi} of several flights.	noun
Hiking is one of her favorite {wi}diversions{/wi}.	noun
turned off her phone to limit {wi}distractions{/wi}	noun
a harmless {wi}distraction{/wi}	noun
One created a {wi}distraction{/wi} while the other grabbed the money.	noun
{wi}disaffected{/wi} youth	adjective
a {wi}smart{/wi} young student	adjective
a {wi}smart{/wi} comedy/sitcom	adjective
a {wi}smart{/wi} decision/investment/idea	adjective
{wi}faded{/wi} jeans	adjective
a {wi}faded{/wi} memory	adjective
a {wi}faded{/wi} photograph from 1931	adjective
an {wi}unbecoming{/wi} dress	adjective
{wi}unbecoming{/wi} conduct	adjective
a {wi}strident{/wi} voice	adjective
{wi}strident{/wi} slogans	adjective
told the children to stop their {wi}fooling{/wi}	verb
living a {wi}charmed{/wi} life	adjective
studied law but {wi}diverted{/wi} to diplomacy	verb
a {wi}straightforward{/wi} account	adjective
{it}glared{/it} at me with rage and hate	verb
{wi}ungraceful{/wi} movements	adjective
an {wi}ungraceful{/wi} dancer	adjective
the balloon {wi}burst{/wi}	verb
my heart will {wi}burst{/wi}	verb
the pipes {wi}burst{/wi}	verb
{wi}volunteered{/wi} to host the meeting	verb
the {it}Iliad{/it} and the {it}Odyssey{/it} are {wi}epics{/wi}	noun
a region that {wi}marches{/wi} with Canada in the north and the Pacific in the west	verb
a {wi}smart{/wi} young student	adjective
a {wi}smart{/wi} comedy/sitcom	adjective
a {wi}smart{/wi} decision/investment/idea	adjective
… crops are grown in the resulting field for a year or a few years until the soil is {wi}exhausted{/wi}, and then the field is abandoned …	adjective
I mean I was just {wi}exhausted{/wi}, totally {wi}exhausted{/wi}. I could barely walk up a flight of stairs without panting and wheezing.	adjective
a {wi}blinding{/wi} light	adjective
a runner with {wi}blinding{/wi} speed	adjective
a {wi}blinding{/wi} snowstorm	adjective
{wi}thin{/wi} paper	adjective
{wi}thin{/wi} hair	adjective
a {it}misspent{/it} life	verb
the flu is {wi}catching{/wi}	adjective
his spirit is {wi}catching{/wi}	adjective
a country heading towards a {wi}depression{/wi}	noun
took down a map and {wi}overlooked{/wi} it	verb
do not like living near water, and prefer not to be {wi}overlooked{/wi}	verb
{it}struck{/it} off through the brush	verb
the {wi}guts{/wi} of a car	noun
was {wi}recalled{/wi} to active duty	verb
a {wi}void{/wi} contract	adjective
{wi}void{/wi} space	adjective
{wi}unconfined{/wi} joy	adjective
… her black hair flowed about her {wi}unconfined{/wi}.	adjective
His first outside shot, however, was blocked, but he came back with a {wi}faked{/wi} shot and then a sweet bounce pass to O'Sullivan for a layup.	adjective
His first outside shot, however, was blocked, but he came back with a {wi}faked{/wi} shot and then a sweet bounce pass to O'Sullivan for a layup.	adjective
Unsuspecting users click on this {wi}faked{/wi} site instead of the real site.	adjective
a {wi}heated{/wi} argument	adjective
an actress who's {wi}dynamite{/wi} at the box office	noun
{wi}sour{/wi} pickles	adjective
tormented by the neighborhood {wi}bully{/wi}	noun
congressmen who {wi}stooge{/wi} for the oil and mineral interests	verb
{wi}confront{/wi} an enemy	verb
{wi}confront{/wi} a reader with statistics	verb
The mayor was {wi}confronted{/wi} by a group of protesters.	verb
so alike they could not be {wi}distinguished{/wi}	verb
a policy that {wi}distinguishes{/wi} him from other candidates	verb
She left us a {wi}legacy{/wi} of a million dollars.	noun
the {wi}legacy{/wi} of the ancient philosophers	noun
the minister {it}pronounced{/it} them husband and wife	verb
doctors {it}pronounced{/it} him fit to resume duties	verb
The patient was placed on {wi}life support{/wi}.	noun
A mechanical pump that was invented as a temporary {wi}life support{/wi} for patients with advanced heart failure is emerging as a potential tool to help hearts heal and function for the long term on their own.	noun
they {it}denounced{/it} him as a bigot	verb
Others might cry or get bent out of shape when their personal tastes are {wi}denounced{/wi} and ridiculed, but not him …	verb
an ax {wi}blunted{/wi} from use	verb
{wi}blunted{/wi} their criticism by praising her enthusiasm	verb
{it}brought{/it} a bottle of wine to the party	verb
{wi}sadistic{/wi} fantasies	adjective
{wi}hunt{/wi} buffalo	verb
{wi}hunted{/wi} the escapees	verb
a catalyst {wi}poison{/wi}	noun
{wi}dismiss{/wi} the visitors	verb
He was {wi}dismissed{/wi} {gloss}=fired{/gloss} from his job.	verb
Class is {wi}dismissed{/wi}.	verb
an insatiable {wi}appetite{/wi} for work	noun
He has a hearty {wi}appetite{/wi}.	noun
He was {wi}hit{/wi} by a car.	verb
The tank was {wi}hit{/wi} by enemy fire.	verb
His mom told him to stop {it}hitting{/it} his sister.	verb
She accidentally {wi}hit{/wi} her head getting into the car.	verb
a rational understanding of the laws of nature can {wi}quench{/wi} impossible desires	verb
a rational understanding of the laws of nature can {wi}quench{/wi} impossible desires	verb
{it}drying{/it} her hair	verb
{wi}lascivious{/wi} acts/thoughts	adjective
arrested for lewd and {wi}lascivious{/wi} assault	adjective
{wi}swirling{/wi} water	verb
{wi}oily{/wi} rags	adjective
{wi}laces{/wi} her fingers behind her head	verb
a {wi}ritual{/wi} dance	adjective
{wi}ritual{/wi} purity	adjective
The {wi}novices{/wi} spend part of each day in prayer and meditation.	noun
{wi}stressing{/wi} the equipment	verb
this traffic is {wi}stressing{/wi} me out	verb
a man of dignified {wi}bearing{/wi}	noun
a woman past {wi}bearing{/wi}	noun
… a confident and cheerful {wi}bearing{/wi}.	noun
fans {wi}lingered{/wi} outside the door	verb
{wi}lingering{/wi} doubts	verb
a {wi}ticklish{/wi} subject	adjective
The {wi}novices{/wi} spend part of each day in prayer and meditation.	noun
a {wi}venerable{/wi} jazz musician	adjective
encouraged by the {wi}venerable{/wi} doctor's head-nodding	adjective
{wi}dictate{/wi} for the stenographer	verb
resents being {it}dictated{/it} to	verb
{wi}plan{/wi} a new layout	verb
{it}planned{/it} their escape	verb
Some jurisdictions are so {wi}overwhelmed{/wi} that they are experimenting with routing school-children into specially designed courts that would keep first-time offenders from being saddled with an arrest record.	adjective
When he first appeared in full regalia, I was {wi}overwhelmed{/wi}.	adjective
Only three Coast Guard rescue helicopters had managed to get into the air, and each was already {wi}overwhelmed{/wi} by dozens of calls for help.	adjective
{wi}explain{/wi} the secret of your success	verb
unable to {wi}explain{/wi} his strange conduct	verb
{wi}arrange{/wi} flowers in a vase	verb
{it}arranged{/it} a reception for the visitor	verb
{wi}arrange{/wi} cards alphabetically	verb
The museum {wi}attracts{/wi} visitors.	verb
The museum {wi}attracts{/wi} visitors.	verb
an organization {wi}staffed{/wi} by volunteers	verb
{wi}pointing{/wi} a pencil with a knife	verb
{wi}stretched{/wi} out her arms	verb
a {wi}querulous{/wi} voice	adjective
St. Andrew is {wi}commemorated{/wi} on November 30.	verb
{wi}commemorate{/wi} an anniversary	verb
an {wi}unruly{/wi} crowd	adjective
a mane of {wi}unruly{/wi} hair	adjective
a {wi}cacophony{/wi} of color	noun
{wi}heroic{/wi} legends	adjective
It was a {wi}heroic{/wi} decision.	adjective
the {wi}heroic{/wi} age	adjective
pride{it}ful{/it}	adjective suffix
peace{it}ful{/it}	adjective suffix
{wi}wheeled{/wi} vehicles	adjective
{wi}wheeled{/wi} traffic	adjective
Much as we try, we can't stop {wi}humanizing{/wi} our horses.	verb
Lincoln forged a new lean language to {wi}humanize{/wi} and redeem the first modern war.	verb
tried to {wi}gather{/wi} a crowd	verb
{wi}gather{/wi} flowers	verb
{wi}gathered{/wi} firewood	verb
people of {wi}slender{/wi} means	adjective
{wi}bold{/wi} settlers on some foreign shore	adjective
punishing a {wi}bold{/wi} child for talking back	adjective
The price of the stock {it}declined{/it}.	verb
his health {it}declined{/it}	verb
{wi}astronomical{/wi} observations	adjective
{wi}astronomical{/wi} numbers	adjective
a {wi}defrocked{/wi} priest	verb
an advertising {wi}blitz{/wi}	noun
constructed a {wi}mythical{/wi} all-star team	adjective
a {wi}tragic{/wi} mistake	adjective
the {wi}tragic{/wi} significance of the atomic bomb	adjective
a civil rights {wi}icon{/wi}	noun
Rosie the Riveter, a WWII [World War II] cultural {wi}icon{/wi} with her blue jumpsuit and red bandana, represented the women who went to work at manufacturing hubs across the nation …	noun
an actor and fashion {wi}icon{/wi}	noun
The king {it}graced{/it} him with the rank of a knight.	verb
graveled walks {it}graced{/it} with statues	verb
{wi}transpose{/wi} letters to change the spelling	verb
Each {wi}facet{/wi} of the problem requires careful attention.	noun
a dormitory with a {wi}shared{/wi} living area	adjective
Despite the {wi}shared{/wi} memory, the PC performed relatively well …	adjective
{wi}shared{/wi} equity	adjective
Charlie Stuart represents a new breed of motorcyclists who are erasing the {wi}stereotypical{/wi} black-leather-jacket, tough-guy image that plagued motorcyclists since the violent Hollywood productions of the Fifties.	adjective
His book concedes that progress has been made in a sheerly numerical sense, but it argues that overall the black presence on television has been an endless recycling of a passel of injuriously {wi}stereotypical{/wi} images.	adjective
{wi}throw{/wi} a baseball	verb
{it}threw{/it} his opponent	verb
a {wi}revealing{/wi} confession	adjective
a {wi}revealing{/wi} halter top	adjective
{wi}uncover{/wi} the truth	verb
an {wi}attractive{/wi} smile	adjective
{wi}attractive{/wi} forces between molecules	adjective
at {wi}close{/wi} range	adjective
{wi}close{/wi} friends	adjective
{wi}close{/wi} to my birthday	adjective
a {wi}directed{/wi} reading program for students	adjective
{wi}directed{/wi} line segment	adjective
bloodied but {wi}unbowed{/wi}	adjective
{wi}disguised{/wi} herself in a wig and glasses	verb
{wi}mix{/wi} a drink at the bar	verb
{wi}dismiss{/wi} the visitors	verb
He was {wi}dismissed{/wi} {gloss}=fired{/gloss} from his job.	verb
Class is {wi}dismissed{/wi}.	verb
{wi}defuse{/wi} a crisis	verb
{wi}thrust{/wi} a dagger into his heart	verb
{wi}leap{/wi} over a fence	verb
the difficult {wi}leap{/wi} from college to the workplace	verb
a fish {wi}leaps{/wi} out of the water	verb
{wi}discovering{/wi} himself … as her adoring and magnanimous lover	verb
{wi}discover{/wi} the solution	verb
{wi}reveal{/wi} a secret	verb
The book {wi}deals{/wi} with education.	verb
{wi}deal{/wi} with an offender	verb
a lawyer who {wi}deals{/wi} with real estate law	verb
is said to {wi}derive{/wi} its name from a Native American word meaning "wild onion"	verb
what was {it}derived{/it} from their observations	verb
a complex {wi}labyrinth{/wi} of tunnels and chambers	noun
a {wi}labyrinth{/wi} of swamps and channels	noun
{wi}violate{/wi} the law	verb
{it}misused{/it} his talents	verb
… their prisoner had the heavy task of receiving their insolence as wit, answering their insults with good-humour, and withholding from them the opportunity which they sought of engaging him in a quarrel, that they might have a pretence for {wi}misusing{/wi} him.	verb
a word that is frequently {it}misused{/it}	verb
one military force {it}opposed{/it} to another	verb
{wi}oppose{/wi} the enemy	verb
concreteness as {it}opposed{/it} to abstraction	verb
Wallace {wi}asserted{/wi} control early—shutting down both candidates when they tried to talk over one another, and shushing the audience when it reacted too audibly.	verb
The suspect continued to {wi}assert{/wi} his innocence.	verb
He wished to vindicate himself in some way, to {wi}assert{/wi} his manhood.	verb
{wi}borderline{/wi} hypertension	adjective
a {wi}borderline{/wi} state between waking and sleeping	adjective
a {wi}borderline{/wi} town	adjective
an unusual {wi}juxtaposition{/wi} of colors	noun
contrasting shapes placed in {wi}juxtaposition{/wi} to each other	noun
free trade {wi}versus{/wi} protection	preposition
a dictator who {wi}banishes{/wi} anyone who opposes him	verb
He was {wi}banished{/wi} from court.	verb
granite stones {wi}harsh{/wi} with lichen	adjective
{wi}harsh{/wi} colors	adjective
{wi}refer{/wi} a patient to a specialist	verb
studied his own life … with a shrewd and {wi}humorous{/wi} eye	adjective
{wi}humorous{/wi} stories	adjective
shared a {wi}humorous{/wi} anecdote	adjective
butterflies {wi}fluttering{/wi} among the flowers	verb
a sail {wi}fluttering{/wi} in the wind	verb
{wi}hollow{/wi} cheeks	adjective
a {wi}hollow{/wi} tree	adjective
selfishness that had a {wi}gloss{/wi} of humanitarianism about it	noun
The soldiers {wi}crawled{/wi} forward on their bellies.	verb
The baby {wi}crawled{/wi} toward her mother.	verb
traffic {wi}crawling{/wi} along at 10 miles an hour	verb
{wi}bluffed{/wi} them into surrendering	verb
was {wi}bluffed{/wi} out of a winning hand	verb
Her own childhood had been made miserable by {wi}bullying{/wi} …	noun
… underestimates the plain meanness behind the pleasure people take in {wi}bullying{/wi}.	noun
can't tell you the answer but can give you a {wi}hint{/wi}	noun
had been dropping {wi}hints{/wi} that he would like to be invited	noun
gave only a {wi}hint{/wi} of what was to come	noun
stared in {wi}blank{/wi} dismay	adjective
their partnership was {it}dissolved{/it}	verb
their partnership was {it}dissolved{/it}	verb
do not {wi}dissolve{/wi} and deface the laws of charity	verb
{wi}dissolve{/wi} sugar in water	verb
{it}paid{/it} a teenager to mow his lawn	verb
{it}paid{/it} the pizza deliverer	verb
{wi}pay{/wi} wages	verb
a floral {wi}tribute{/wi}	noun
They were {wi}fighting{/wi} to stay awake.	verb
The soldiers {it}fought{/it} bravely.	verb
So far, I've had the {wi}common sense{/wi} not to tweet anything ghastly.	noun
The poker players learns that sometimes both science and {wi}common sense{/wi} are wrong. There is such a thing as absolute premonition of cards, a rock bottom surety of what will happen next.	noun
didn't {wi}exercise{/wi} good judgment	verb
{wi}exercise{/wi} a muscle	verb
an idea that {wi}appeals{/wi} to him	verb
We {wi}appealed{/wi} to them for help.	verb
{wi}define{/wi} a procedure	verb
{wi}define{/wi} a procedure	verb
whatever {wi}defines{/wi} us as human	verb
rigidly {it}defined{/it} property lines	verb
{wi}envisages{/wi} the slum as a hotbed of crime	verb
{wi}envisages{/wi} an entirely new system of education	verb
a river that {wi}arises{/wi} from two main sources	verb
Problems {wi}arise{/wi} when people try to avoid responsibility.	verb
He {wi}arose{/wi} from his chair.	verb
A conflict {wi}arose{/wi} because of a misunderstanding.	verb
{wi}adapt{/wi} the curriculum to students' needs	verb
{wi}enact{/wi} a role	verb
{wi}enact{/wi} a bill	verb
seemed to be talking {wi}uphill{/wi}	adverb
{wi}beaten{/wi} gold	adjective
{it}struggling{/it} with the problem	verb
{it}struggled{/it} through the high grass	verb
{wi}margin{/wi} up an account	verb
trying to {wi}undermine{/wi} his political rivals	verb
a plumbing {wi}fixture{/wi}	noun
{wi}boosted{/wi} him up over the fence	verb
plans to {wi}boost{/wi} production	verb
{wi}powerless{/wi} victims	adjective
was {wi}powerless{/wi} to help	adjective
a {wi}lighthearted{/wi} mood	adjective
they can be {wi}lighthearted{/wi} in the midst of misery	adjective
The pill left a {wi}bitter{/wi} taste in my mouth.	adjective
{wi}bitter{/wi} beer	adjective
liquid {wi}damps{/wi} out compass oscillations	verb
a {wi}recovering{/wi} alcoholic	adjective
a still-bookish {wi}recovering{/wi} academic with a tendency to live in his head	adjective
yellow leaves {wi}floated{/wi} down	verb
{wi}smothered{/wi} his rage	verb
health-care {wi}providers{/wi}	noun
an Internet {wi}provider{/wi}	noun
the dishes {wi}clattered{/wi} on the shelf	verb
{wi}drill{/wi} pupils in spelling	verb
{wi}stitched{/wi} a seam	verb
the boy {wi}stuffed{/wi} his pockets with candy	verb
{wi}stuffing{/wi} their heads with facts	verb
unable to pay off his {wi}debts{/wi}	noun
deeply in {wi}debt{/wi} to creditors	noun
owe them a {wi}debt{/wi} of gratitude	noun
the windows {it}rattled{/it} in the wind	verb
Her {wi}cure{/wi} was complete.	noun
{wi}leap{/wi} over a fence	verb
the difficult {wi}leap{/wi} from college to the workplace	verb
a fish {wi}leaps{/wi} out of the water	verb
had no {wi}clue{/wi} what he meant	noun
{wi}phases{/wi} of the moon	noun
the early {wi}phases{/wi} of her career	noun
{wi}prohibitive{/wi} costs	adjective
studied the French {wi}language{/wi}	noun
{wi}overturned{/wi} the vase	verb
the degree to which accident could {wi}overturn{/wi} the schemes of wise men	verb
{wi}musters{/wi} of goods for sale	noun
the project {wi}halted{/wi} for lack of funds	verb
{wi}contribute{/wi} money to a cause	verb
He {wi}contributed{/wi} several poems to the magazine.	verb
{wi}contributed{/wi} canned goods to the food drive	verb
{wi}tread{/wi} a path	verb
a positive {wi}outlook{/wi} on life	noun
{wi}feverish{/wi} excitement	adjective
{it}dodged{/it} through the crowd	verb
The ground was covered with a {wi}mantle{/wi} of leaves.	noun
{wi}felled{/wi} trees/timber	adjective
{wi}provoke{/wi} laughter	verb
{wi}unarmed{/wi} civilians	adjective
{wi}unarmed{/wi} robbery	adjective
{it}struck{/it} off through the brush	verb
cymbals {wi}clashed{/wi}	verb
where ignorant armies {wi}clash{/wi} by night	verb
a {wi}diffuse{/wi} report from the scene of the earthquake	adjective
{wi}diffuse{/wi} lighting	adjective
{it}swept{/it} the crumbs from the table	verb
{wi}construct{/wi} a bridge	verb
{wi}Construct{/wi} a regular hexagon with sides 3 inches long.	verb
{wi}construct{/wi} a plan	verb
The batteries provide enough power for up to five hours of {wi}continuous{/wi} use.	adjective
at {wi}close{/wi} range	adjective
{wi}close{/wi} friends	adjective
{wi}close{/wi} to my birthday	adjective
{wi}infuse{/wi} the team with confidence	verb
the sense of purpose that {it}infuses{/it} scientific research	verb
{wi}thrust{/wi} a dagger into his heart	verb
{wi}crested{/wi} the hill and looked around	verb
a {wi}unidirectional{/wi} microphone	adjective
The buccaneer on the {wi}wave{/wi} might relinquish his calling and become … a man of probity and piety on land …	noun
The sea was open to them, and they achieved their victories on the briny {wi}wave{/wi}.	noun
a mirror {wi}reflects{/wi} light	verb
the clouds were {wi}reflected{/wi} in the water	verb
"We have not the strength with which to fight this man; we must … win, if win we can, by {wi}craft{/wi}."	noun
the carpenter's {wi}craft{/wi}	noun
{wi}destroyed{/wi} the files	verb
{wi}destroy{/wi} an injured horse	verb
their reputation was {wi}destroyed{/wi}	verb
The missing boy was returned to his home {wi}unharmed{/wi}.	adjective
Film and paint companies are using computers to design dyes that will survive sunlight but leave humans {wi}unharmed{/wi}.	adjective
the troops {wi}embarked{/wi} at noon	verb
{wi}embarked{/wi} on a new career	verb
She was {wi}declared{/wi} the rightful heir to the throne.	verb
publicly {it}declared{/it} her opposition to the plan	verb
{wi}defuse{/wi} a crisis	verb
{wi}marginal{/wi} notes	adjective
{wi}hostile{/wi} to new ideas	adjective
{wi}hostile{/wi} to new ideas	adjective
{wi}hostile{/wi} fire	adjective
a {wi}hostile{/wi} witness	adjective
the {wi}soft{/wi} influences of home	adjective
a {wi}soft{/wi} job	adjective
{it}gazed{/it} out the window at the snow	verb
a {wi}whining{/wi} howl	adjective
They [scientists] think that … joyful people outlive their bilious, {wi}whining{/wi} counterparts.	adjective
… a coil of steel spins through a {wi}whining{/wi} mass of machinery the size of a small two-story house.	adjective
{wi}gulp{/wi} down a sob	verb
{wi}wiry{/wi} stems	adjective
the {wi}wiry{/wi} figure of a long-distance runner	adjective
{wi}queasy{/wi} motion	adjective
{it}mopped{/it} his brow with a handkerchief	verb
{wi}mop{/wi} the floors	verb
{it}repelled{/it} the insinuation	verb
a {it}well-connected{/it} lawyer	adjective
a {wi}substantial{/wi} meal	adjective
{wi}qualified{/wi} approval	adjective
an {wi}irresistible{/wi} attraction	adjective
He {wi}leaned{/wi} back in his chair.	verb
… preferred not to {wi}lean{/wi} on his father in building a career.	verb
Something about the smile {wi}lurking{/wi} on Malfoy's face during the next week made Harry, Ron, and Hermione very nervous.	verb
Something about the smile {wi}lurking{/wi} on Malfoy's face during the next week made Harry, Ron, and Hermione very nervous.	verb
someone out there {wi}lurking{/wi} in the shadows	verb
{wi}throw{/wi} a baseball	verb
{it}threw{/it} his opponent	verb
{wi}assiduous{/wi} planning	adjective
an {wi}assiduous{/wi} book collector	adjective
comfortably {wi}fixed{/wi}	adjective
a {wi}smart{/wi} young student	adjective
a {wi}smart{/wi} comedy/sitcom	adjective
a {wi}smart{/wi} decision/investment/idea	adjective
of French {wi}descent{/wi}	noun
begin our {wi}descent{/wi} down the mountain	noun
patrilineal {wi}descent{/wi}	noun
an advertising {wi}juggernaut{/wi}	noun
a political {wi}juggernaut{/wi}	noun
… his overly erect posture and {wi}overemphatic{/wi} diction make him come off like an enraged headwaiter.	adjective
… the … posturing and {wi}overemphatic{/wi} gesturing needed to reach the balcony in theater …	adjective
People believe that there is a {wi}curse{/wi} on the house.	noun
In an antechamber, his lieutenants suddenly heard the shattering of glass and angry {wi}curses{/wi}.	noun
{wi}sort{/wi} apples	verb
{wi}sort{/wi} mail	verb
agreed, but with {wi}reservations{/wi}	noun
a {wi}tasty{/wi} meal	adjective
Bad weather forced the {wi}diversion{/wi} of several flights.	noun
Hiking is one of her favorite {wi}diversions{/wi}.	noun
turned off her phone to limit {wi}distractions{/wi}	noun
a harmless {wi}distraction{/wi}	noun
One created a {wi}distraction{/wi} while the other grabbed the money.	noun
{wi}disaffected{/wi} youth	adjective
a {wi}smart{/wi} young student	adjective
a {wi}smart{/wi} comedy/sitcom	adjective
a {wi}smart{/wi} decision/investment/idea	adjective
{wi}faded{/wi} jeans	adjective
a {wi}faded{/wi} memory	adjective
a {wi}faded{/wi} photograph from 1931	adjective
an {wi}unbecoming{/wi} dress	adjective
{wi}unbecoming{/wi} conduct	adjective
a {wi}strident{/wi} voice	adjective
{wi}strident{/wi} slogans	adjective
told the children to stop their {wi}fooling{/wi}	verb
living a {wi}charmed{/wi} life	adjective
studied law but {wi}diverted{/wi} to diplomacy	verb
a {wi}straightforward{/wi} account	adjective
{it}glared{/it} at me with rage and hate	verb
{wi}ungraceful{/wi} movements	adjective
an {wi}ungraceful{/wi} dancer	adjective
the balloon {wi}burst{/wi}	verb
my heart will {wi}burst{/wi}	verb
the pipes {wi}burst{/wi}	verb
{wi}volunteered{/wi} to host the meeting	verb
the {it}Iliad{/it} and the {it}Odyssey{/it} are {wi}epics{/wi}	noun
a region that {wi}marches{/wi} with Canada in the north and the Pacific in the west	verb
a {wi}smart{/wi} young student	adjective
a {wi}smart{/wi} comedy/sitcom	adjective
a {wi}smart{/wi} decision/investment/idea	adjective
… crops are grown in the resulting field for a year or a few years until the soil is {wi}exhausted{/wi}, and then the field is abandoned …	adjective
I mean I was just {wi}exhausted{/wi}, totally {wi}exhausted{/wi}. I could barely walk up a flight of stairs without panting and wheezing.	adjective
a {wi}blinding{/wi} light	adjective
a runner with {wi}blinding{/wi} speed	adjective
a {wi}blinding{/wi} snowstorm	adjective
{wi}thin{/wi} paper	adjective
{wi}thin{/wi} hair	adjective
a {it}misspent{/it} life	verb
the flu is {wi}catching{/wi}	adjective
his spirit is {wi}catching{/wi}	adjective
a country heading towards a {wi}depression{/wi}	noun
took down a map and {wi}overlooked{/wi} it	verb
do not like living near water, and prefer not to be {wi}overlooked{/wi}	verb
{it}struck{/it} off through the brush	verb
the {wi}guts{/wi} of a car	noun
was {wi}recalled{/wi} to active duty	verb
a {wi}void{/wi} contract	adjective
{wi}void{/wi} space	adjective
{wi}unconfined{/wi} joy	adjective
… her black hair flowed about her {wi}unconfined{/wi}.	adjective
His first outside shot, however, was blocked, but he came back with a {wi}faked{/wi} shot and then a sweet bounce pass to O'Sullivan for a layup.	adjective
His first outside shot, however, was blocked, but he came back with a {wi}faked{/wi} shot and then a sweet bounce pass to O'Sullivan for a layup.	adjective
Unsuspecting users click on this {wi}faked{/wi} site instead of the real site.	adjective
a {wi}heated{/wi} argument	adjective
an actress who's {wi}dynamite{/wi} at the box office	noun
{wi}sour{/wi} pickles	adjective
tormented by the neighborhood {wi}bully{/wi}	noun
congressmen who {wi}stooge{/wi} for the oil and mineral interests	verb
{wi}confront{/wi} an enemy	verb
{wi}confront{/wi} a reader with statistics	verb
The mayor was {wi}confronted{/wi} by a group of protesters.	verb
so alike they could not be {wi}distinguished{/wi}	verb
a policy that {wi}distinguishes{/wi} him from other candidates	verb
She left us a {wi}legacy{/wi} of a million dollars.	noun
the {wi}legacy{/wi} of the ancient philosophers	noun
the minister {it}pronounced{/it} them husband and wife	verb
doctors {it}pronounced{/it} him fit to resume duties	verb
The patient was placed on {wi}life support{/wi}.	noun
A mechanical pump that was invented as a temporary {wi}life support{/wi} for patients with advanced heart failure is emerging as a potential tool to help hearts heal and function for the long term on their own.	noun
they {it}denounced{/it} him as a bigot	verb
Others might cry or get bent out of shape when their personal tastes are {wi}denounced{/wi} and ridiculed, but not him …	verb
an ax {wi}blunted{/wi} from use	verb
{wi}blunted{/wi} their criticism by praising her enthusiasm	verb
{it}brought{/it} a bottle of wine to the party	verb
{wi}sadistic{/wi} fantasies	adjective
{wi}enact{/wi} a role	verb
{wi}enact{/wi} a bill	verb
an {wi}individual{/wi} effort	adjective
an {wi}individual{/wi} style	adjective
In its ruling the Court also criticized contemporary interrogation practices, finding in effect that a psychological {wi}third degree{/wi} had replaced the physical {wi}third degree{/wi}.	noun
{wi}second-degree{/wi} assault/murder	adjective
a {wi}second-degree{/wi} concussion	adjective
a pair of doves {wi}billing{/wi}	verb
{wi}billing{/wi} and cooing	verb
{wi}contemplate{/wi} the vastness of the universe	verb
{wi}contemplate{/wi} marriage	verb
{it}contemplated{/it} the meaning of the poem	verb
{wi}violate{/wi} the law	verb
{wi}wanton{/wi} cruelty	adjective
The name is prominently displayed on the {wi}label{/wi}.	noun
a {wi}breach{/wi} of trust	noun
a {wi}breach{/wi} of the skin	noun
sued them for {wi}breach{/wi} of contract	noun
{wi}assume{/wi} responsibility	verb
{wi}assume{/wi} control	verb
The tornado {wi}overwhelmed{/wi} many mobile homes.	verb
The city was {wi}overwhelmed{/wi} by the flooding caused by the hurricane.	verb
X-rays {wi}directed{/wi} through the body	verb
{wi}direct{/wi} the nozzle downward	verb
She {wi}assisted{/wi} the boy with his lessons.	verb
went to them as a last {wi}resort{/wi}	noun
a place of popular {wi}resort{/wi}	noun
{wi}bounce{/wi} a ball	verb
{wi}bonded{/wi} jersey	adjective
{wi}usurp{/wi} a throne	verb
must not let stock responses based on inherited prejudice {wi}usurp{/wi} careful judgment	verb
the {wi}threads{/wi} of a spiderweb	noun
an {wi}inhospitable{/wi} environment	adjective
Don't {wi}blow{/wi} on your soup.	verb
{wi}reconstructing{/wi} a lost civilization	verb
too many {wi}lonely{/wi} nights at home	adjective
a {wi}lonely{/wi} spot in the woods	adjective
senators trying to {wi}block{/wi} passage of the bill	verb
senators trying to {wi}block{/wi} passage of the bill	verb
The road was {wi}blocked{/wi} by a rock slide.	verb
{wi}block{/wi} out a design	verb
a road {wi}flanked{/wi} with linden trees	verb
had no {wi}clue{/wi} what he meant	noun
floors {wi}sheeted{/wi} with dust	verb
a {wi}jarring{/wi} tackle	adjective
It is not hard to imagine how the wounded will fare in a long {wi}jarring{/wi} ride over rough roads …	adjective
they were forced to {wi}cease{/wi} operations	verb
{wi}cease{/wi} to exist	verb
a {wi}crisp{/wi} cracker	adjective
a {wi}crisp{/wi} illustration	adjective
this route … {wi}penetrates{/wi} the leading resort and lake areas	verb
their keen eyes can {wi}penetrate{/wi} the water to a depth of … forty feet	verb
Only a dirt road {wi}penetrates{/wi} the rough, wooded terrain.	verb
{wi}grim{/wi} wolves	adjective
a {wi}grim{/wi} taskmaster	adjective
{wi}tense{/wi} muscles	adjective
a {wi}tense{/wi} smile	adjective
limped on a {wi}sore{/wi} leg	adjective
felt {wi}sore{/wi} all over	adjective
a {wi}sore{/wi} subject	adjective
a {wi}canny{/wi} lawyer	adjective
{wi}canny{/wi} investments	adjective
Bad weather forced the {wi}diversion{/wi} of several flights.	noun
Hiking is one of her favorite {wi}diversions{/wi}.	noun
the {wi}tide{/wi} of public opinion	noun
a movie {wi}awash{/wi} in sentimentality	adjective
{wi}hard{/wi} surfaces	adjective
an uncomfortably {wi}hard{/wi} chair	adjective
a {wi}painful{/wi} injury	adjective
a long {wi}painful{/wi} trip	adjective
{wi}hacked{/wi} his way through the brush	verb
{wi}fodder{/wi} for tabloids	noun
{wi}rebuild{/wi} a war-torn city	verb
{wi}rebuild{/wi} society	verb
trying to {wi}judge{/wi} the amount of time required	verb
{wi}roaring{/wi} applause	adjective
a river that {wi}arises{/wi} from two main sources	verb
Problems {wi}arise{/wi} when people try to avoid responsibility.	verb
He {wi}arose{/wi} from his chair.	verb
A conflict {wi}arose{/wi} because of a misunderstanding.	verb
an {wi}advocate{/wi} of liberal arts education	noun
a consumer {wi}advocate{/wi}	noun
the {wi}jubilant{/wi} winner	adjective
migrant labor {wi}camp{/wi}	noun
new data that {wi}challenges{/wi} old assumptions	verb
he {it}challenged{/it} his critics to prove his guilt	verb
a {wi}big{/wi} house	adjective
I'm a {wi}big{/wi} fan of soy foods but urge you to choose them wisely.	adjective
a {wi}big{/wi} fleet	adjective
a {wi}fair-weather{/wi} friend	adjective
a {wi}fair-weather{/wi} sail	adjective
{wi}barrier{/wi} beaches	noun
drugs that cross the placental {wi}barrier{/wi}	noun
highway {wi}barriers{/wi}	noun
a {wi}barrier{/wi} contraceptive	noun
a {wi}robust{/wi} faith	adjective
stories … laden with {wi}robust{/wi}, down-home imagery	adjective
a {wi}cauldron{/wi} of intense emotions	noun
fish {it}snapping{/it} at the bait	verb
The bank customers waited {wi}patiently{/wi} for the next teller.	adverb
She very {wi}patiently{/wi} answered all our questions.	adverb
{wi}chart{/wi} a course	verb
{wi}chart{/wi} the coastline	verb
{wi}distribute{/wi} expenses	verb
evenly {wi}distribute{/wi} the seeds	verb
{wi}distributes{/wi} toys to needy children	verb
a celebrity {it}worshipped{/it} by her fans	verb
an {wi}unqualified{/wi} denial	adjective
alleged {it}irregularities{/it} in the city government	noun
whatever fate may {wi}send{/wi}	verb
{wi}dip{/wi} candles	verb
{it}owed{/it} his wealth to his father	verb
{it}overstated{/it} his qualifications	verb
The wagon gained {wi}momentum{/wi} as it rolled down the hill.	noun
{wi}nailed{/wi} his eye on the crack	verb
{wi}keen{/wi} debate	adjective
{wi}keen{/wi} debate	adjective
a {wi}keen{/wi} sense of smell	adjective
a {wi}keen{/wi} student	adjective
a {wi}keen{/wi} assessment	adjective
a {wi}keen{/wi} awareness of the problem	adjective
a cigarette {wi}holder{/wi}	noun
{wi}targeted{/wi} her for promotion	verb
a {wi}swift{/wi} runner	adjective
a {wi}swift{/wi} transition	adjective
man {wi}proposes{/wi}, but God disposes	verb
He {it}applies{/it} pressure to get what he wants.	verb
You should {wi}apply{/wi} yourself to your work.	verb
This is a side of her {wi}character{/wi} that few people have seen.	noun
a {wi}character{/wi} in a play	noun
backed down in a moment of {wi}weakness{/wi}	noun
{wi}underpin{/wi} a thesis with evidence	verb
{wi}underpin{/wi} a structure	verb
{wi}assimilate{/wi} information	verb
Students need to {wi}assimilate{/wi} new concepts.	verb
{wi}unfolded{/wi} the map	verb
She {it}aspired{/it} to a career in medicine.	verb
Visiting the Alps was a {wi}highlight{/wi} of their trip to Europe.	noun
the project will {wi}entail{/wi} considerable expense	verb
{wi}employ{/wi} a pen for sketching	verb
{wi}employed{/wi} all her energies to help the poor	verb
{wi}commit{/wi} a crime	verb
a contract {wi}committing{/wi} the company to complete the project on time	verb
{wi}commit{/wi} a sin	verb
a {wi}revolving{/wi} platform	adjective
{wi}extended{/wi} both her arms	verb
… serves to {wi}reanimate{/wi} the old debates about the relationship between form and content …	verb
… serves to {wi}reanimate{/wi} the old debates about the relationship between form and content …	verb
… Nathan would sit in the kitchen … watching Eleanor smoke cigarettes and squeeze lemons into her diet Coke, of which she drank sixty ounces a day—enough, as Major Ray often declared, to {wi}reanimate{/wi} a dead body.	verb
a {wi}vivid{/wi} sketch	adjective
{wi}reconstruction{/wi} efforts to repair hurricane damage	noun
the historical {wi}reconstruction{/wi} of an ancient village	noun
the {wi}reconstruction{/wi} of the dam	noun
I needed money, and they {it}accommodated{/it} me with a loan.	verb
rebuilt the ship to {wi}accommodate{/wi} the bigger containers	verb
{wi}diagnosis{/wi} of engine trouble	noun
{wi}impose{/wi} a tax	verb
{wi}impose{/wi} oneself on others	verb
{wi}impose{/wi} new restrictions	verb
a {wi}ferocious{/wi} predator	adjective
{wi}ferocious{/wi} heat	adjective
the {wi}ferocious{/wi} butchery of women and children	adjective
refused to {wi}cooperate{/wi} with the police	verb
nations {it}cooperating{/it} to fight terrorism	verb
{wi}hunt{/wi} buffalo	verb
{wi}hunted{/wi} the escapees	verb
imports most {wi}manufactures{/wi} used by consumers	noun
the {wi}manufacture{/wi} of automobiles	noun
{wi}design{/wi} a system for tracking inventory	verb
he {wi}designed{/wi} the perfect crime	verb
She's a frequent {wi}flier{/wi} on that airline.	noun
He was a {wi}flier{/wi} on an aircraft carrier.	noun
a competitive {wi}swimmer{/wi}	noun
a fast/strong {wi}swimmer{/wi}	noun
{wi}pursue{/wi} a goal	verb
They {it}occupied{/it} themselves with video games.	verb
this chair is {it}occupied{/it}	verb
finally found her {wi}niche{/wi}	noun
Pursuing pleasure has been his major {wi}occupation{/wi}.	noun
the last of the historic private houses in the metropolis … still in the {wi}occupation{/wi} of its hereditary owner	noun
factors {it}operating{/it} against our success	verb
the drug {it}operated{/it} quickly	verb
{wi}columns{/wi} of numbers	noun
a sense of {wi}belonging{/wi}	noun
{wi}attain{/wi} a goal	verb
he {wi}attained{/wi} preferment over his fellows	verb
a {wi}joint{/wi} between two pieces of timber	noun
{wi}extended{/wi} both her arms	verb
a {wi}veined{/wi} leaf	adjective
{wi}veined{/wi} marble	adjective
his tears were {wi}tokens{/wi} of his grief	noun
{wi}harvesting{/wi} corn	verb
has now {wi}harvested{/wi} this new generation's scholarly labors	verb
they {it}puzzled{/it} their wits to find a solution	verb
The museum {wi}attracts{/wi} visitors.	verb
The museum {wi}attracts{/wi} visitors.	verb
{wi}disprove{/wi} a theory	verb
a river that {wi}arises{/wi} from two main sources	verb
Problems {wi}arise{/wi} when people try to avoid responsibility.	verb
He {wi}arose{/wi} from his chair.	verb
A conflict {wi}arose{/wi} because of a misunderstanding.	verb
a business that has been operating {wi}continuously{/wi} for more than 50 years	adverb
a monitoring system that runs {wi}continuously{/wi}	adverb
The parish council consisted of both clergy and {it}laymen{/it}.	noun
For a {wi}layman{/wi}, he knows a lot about the law.	noun
… hopes motherhood will be the {wi}springboard{/wi} that relaunches her stagnant acting career.	noun
the {wi}tide{/wi} of public opinion	noun
{wi}slacken{/wi} speed at a crossing	verb
{wi}slacken{/wi} sail	verb
movement is {wi}fueled{/wi} by massive grants-in-aid	verb
An infected person will feel a general {wi}malaise{/wi}.	noun
a {wi}malaise{/wi} of cynicism and despair	noun
The {it}crisis{/it} of the play occurs in Act 3.	noun
a blood vessel that {wi}collapsed{/wi}	verb
… his case had {wi}collapsed{/wi} in a mass of legal wreckage …	verb
a {wi}devastating{/wi} flood/earthquake	adjective
a {wi}devastating{/wi} loss	adjective
a {wi}devastating{/wi} injury	adjective
… my {wi}dimensions{/wi} are as well compact, my mind as generous, and my shape as true …	noun
a highly {wi}ranked{/wi} prospect	verb
a {wi}vicious{/wi} dog	adjective
{wi}vicious{/wi} gossip	adjective
{wi}generating{/wi} profits/growth	verb
{wi}generating{/wi} profits/growth	verb
these stories … {wi}generate{/wi} a good deal of psychological suspense	verb
how {wi}heavy{/wi} is it?	adjective
a {wi}barricaded{/wi} building	adjective
a {wi}barricaded{/wi} street/door	adjective
{wi}inflated{/wi} prices	adjective
a dog {it}chasing{/it} a rabbit	verb
the bride and her {wi}attendants{/wi}	noun
the sword, ring, armor, and other {wi}attendants{/wi} of knighthood	noun
a gas-station {wi}attendant{/wi}	noun
{wi}symptoms{/wi} of an inner turmoil	noun
an {wi}automatic{/wi} transmission	adjective
{wi}automatic{/wi} blinking of the eyelids	adjective
{wi}companionable{/wi} people	adjective
{wi}companionable{/wi} laughter	adjective
{wi}diagnosis{/wi} of engine trouble	noun
his teeth were {wi}firm{/wi}	adjective
With her hair in tight curls that {wi}accentuate{/wi} her pale beauty, she seems lit from within.	verb
{wi}accentuates{/wi} the feeling of despair	verb
trying to {wi}accentuate{/wi} the positive aspects of the program	verb
{wi}administer{/wi} a trust fund	verb
{wi}administer{/wi} justice	verb
{wi}definable{/wi} keys	adjective
{wi}debilitating{/wi} pain	adjective
a {wi}debilitating{/wi} fear of public speaking	adjective
He could not have {it}foreseen{/it} the consequences of his actions.	verb
She {it}foresaw{/it} the company's potential and invested early on.	verb
{wi}flexible{/wi} branches swaying in the breeze	adjective
a {wi}flexible{/wi} person without strong convictions	adjective
{wi}discredit{/wi} a rumor	verb
trying to {wi}discredit{/wi} the claims of a rival	verb
{wi}barrier{/wi} beaches	noun
drugs that cross the placental {wi}barrier{/wi}	noun
highway {wi}barriers{/wi}	noun
a {wi}barrier{/wi} contraceptive	noun
Deforestation and erosion can lead to an ecological {wi}catastrophe{/wi}.	noun
the party was a {wi}catastrophe{/wi}	noun
territorial {wi}expansion{/wi}	noun
{wi}scrap{/wi} outworn methods	verb
a {it}receding{/it} hairline	verb
a {it}receding{/it} deficit	verb
the {wi}interplay{/wi} of opposing forces	noun
{wi}Drifting{/wi} began in the early 1980s with a Japanese race-car driver named Keiichi Tsuchiya. Mr. Tsuchiya, who was in his 20s, started experimenting with {wi}drifting{/wi} and practiced it on curvy roads deep in the mountains near his hometown. He says he was perfecting his ability to not spin out on curves in car races.	noun
{wi}Drifting{/wi} has nothing to do with racing. There's no checkered flag. It's more like figure skating than speed skating, with a three-judge panel awarding points based on speed, angle of attack and style. They take points away for going off course, stalling or running into course markers—including walls. And for driving straight: The goal is to control the car as it slides sideways around turns, as if on ice, at full throttle.	noun
in the {wi}midst{/wi} of the forest	noun
a traitor in our {wi}midst{/wi}	noun
the {wi}specter{/wi} of hunger	noun
These thoughtful amenities include … an outdoor patio TV that {wi}hinges{/wi} outward toward the pool …	verb
… we pulled within feet of a 12-foot crocodile, his huge jaw {wi}hinging{/wi} open in warning to reveal a toothy grin.	verb
an {wi}exchange{/wi} of prisoners	noun
to gain a broader {wi}perspective{/wi} on the international scene	noun
places the issues in proper {wi}perspective{/wi}	noun
{wi}powerless{/wi} victims	adjective
was {wi}powerless{/wi} to help	adjective
{it}bridging{/it} a river	verb
small {it}bridged{/it} streams	verb
{wi}bridge{/wi} the divisions between the two groups	verb
… its disregard of the {wi}continuity{/wi} between means and ends …	noun
{wi}breached{/wi} the castle wall	verb
{wi}breach{/wi} an agreement	verb
yet every mother {wi}breeds{/wi} not sons alike	verb
He {it}bred{/it} a daughter.	verb
{wi}engaged{/wi} his all in the king's cause	verb
Roman {it}orgies{/it} in honor of Bacchus	noun
The criminals avoided/eluded/escaped {wi}capture{/wi}.	noun
… authorities increased the reward for information leading to his {wi}capture{/wi} …	noun
an {wi}unhappy{/wi} coincidence	adjective
Nearby residents typically want every shovelful of {wi}tainted{/wi} soil dug up and shipped far, far away.	adjective
… federal health authorities identified an organic produce company … as a possible source of some of the {wi}tainted{/wi} spinach.	adjective
{wi}deploy{/wi} a sales force	verb
bonfires {wi}clear{/wi} and bright	adjective
a {wi}burned-out{/wi} building	adjective
a {wi}litter{/wi} carried on the shoulders of four men	noun
She and her husband drove {wi}separately{/wi} to the restaurant.	adverb
The software is sold {wi}separately{/wi} from the hardware.	adverb
{wi}broad{/wi} shoulders	adjective
the {wi}broad{/wi} plains	adjective
… one of the {wi}broadest{/wi} estuaries of any river in America.	adjective
The soldiers helped themselves to any {wi}loot{/wi} that they could find.	noun
The company will {wi}locate{/wi} north of the city.	verb
{wi}depoliticize{/wi} foreign aid	verb
The country was {wi}governed{/wi} by a king.	verb
the force is {wi}exerted{/wi} sideways	verb
{wi}exerted{/wi} a bad influence on his students	verb
{wi}extract{/wi} data	verb
{wi}deploy{/wi} a sales force	verb
The forest is part of the king's {wi}domain{/wi}.	noun
is said to {wi}derive{/wi} its name from a Native American word meaning "wild onion"	verb
what was {it}derived{/it} from their observations	verb
He liked to {wi}display{/wi} his extensive knowledge of Greek mythology.	verb
He liked to {wi}display{/wi} his extensive knowledge of Greek mythology.	verb
{wi}displayed{/wi} an interest in music	verb
She {wi}displayed{/wi} no emotion upon hearing the news.	verb
The gallery {wi}displays{/wi} the work of local artists.	verb
… a … shop window {wi}displaying{/wi} shimmering silk scarves …	verb
It also comes with a wooden wall mount so you can proudly {wi}display{/wi} it in your living room.	verb
a {wi}crude{/wi} stereotype	adjective
{wi}crude{/wi} oil	adjective
{wi}crude{/wi} tools	adjective
{wi}regulate{/wi} one's habits	verb
a {wi}handful{/wi} of people	noun
was weak at bat but strong {wi}at field{/wi}	adverb
The game requires excellent hand-eye {wi}coordination{/wi}.	noun
{wi}forged{/wi} signatures	adjective
{wi}forged{/wi} blades	adjective
{wi}permit{/wi} access to records	verb
The novel is told from two major {wi}viewpoints{/wi} and a number of minor ones …	noun
As with politics, he'd eventually come around to the opposite {wi}viewpoint{/wi} from the one he'd previously advocated and express it just as stridently.	noun
{wi}contemplate{/wi} the vastness of the universe	verb
{wi}contemplate{/wi} marriage	verb
{it}contemplated{/it} the meaning of the poem	verb
{wi}render{/wi} suet	verb
{wi}render{/wi} lard	verb
Her remarks {wi}implied{/wi} a threat.	verb
rights {wi}imply{/wi} obligations	verb
The news report seems to {wi}imply{/wi} his death was not an accident.	verb
He {wi}vigorously{/wi} denied the accusations.	adverb
In a medium bowl, {wi}vigorously{/wi} stir together the remaining ingredients, except for the pine nuts, to make the filling.	adverb
{wi}interface{/wi} a machine with a computer	verb
a {wi}sullen{/wi} crowd	adjective
{wi}dim{/wi} the headlights	verb
{it}dimmed{/it} their hopes of an early settlement	verb
the {wi}lure{/wi} of adventure	noun
{wi}bait{/wi} minority groups	verb
the {wi}murky{/wi} bottom of the lake	adjective
rain poured down from {wi}murky{/wi} skies	adjective
aroused the {wi}tiger{/wi} in him	noun
{it}tie up{/it} the loose ends	verb
a {wi}dark{/wi} room	adjective
{wi}dark{/wi} clothing	adjective
{wi}ceremonial{/wi} rites	adjective
his new position is largely {wi}ceremonial{/wi}	adjective
She loves you, you {wi}dummy{/wi}.	noun
She loves you, you {wi}dummy{/wi}.	noun
Shakespeare's crones {it}cackled{/it} of evil deeds	verb
{wi}jagged{/wi} peaks	adjective
{wi}jagged{/wi} rhythms	adjective
She's a political {wi}chameleon{/wi}.	noun
a {wi}tough{/wi} question	adjective
{wi}tough{/wi} soldiers	adjective
{wi}tough{/wi} luck	adjective
{wi}square{/wi} a building stone	verb
{it}squared{/it} his shoulders	verb
Her mother, inclined at first to attribute her complaints to moping, took a second look at her {wi}flushed{/wi} cheeks and put her to bed.	adjective
The man opposite looked {wi}flushed{/wi}. … The broken veins on his cheeks were probably a sign of bad circulation and excessive drinking.	adjective
fish {it}snapping{/it} at the bait	verb
the dog {it}nipped{/it} his ankle	verb
{wi}nipped{/wi} the dead flowers from the plant	verb
{wi}popped{/wi} him in the jaw	verb
{wi}pops{/wi} a grape into his mouth	verb
the building {it}trembled{/it} from the blast	verb
{wi}attack{/wi} an enemy fortification	verb
a politician verbally {wi}attacked{/wi} by critics	verb
corruption spreading its {wi}tentacles{/wi}	noun
an elephant {wi}lumbering{/wi} along the road	verb
{wi}lumbering{/wi} machines	verb
The economy continues to {wi}lumber{/wi} along.	verb
{it}struggling{/it} with the problem	verb
{it}struggled{/it} through the high grass	verb
impostors that {wi}haunt{/wi} the official in foreign ports	verb
spends a lot of time {wi}haunting{/wi} bookstores	verb
problems we ignore now will come back to {wi}haunt{/wi} us	verb
… they knew that, {wi}barring{/wi} a miracle, they would never be able to save the large cash outlay required …	preposition
an {wi}alien{/wi} environment	adjective
ideas {wi}alien{/wi} to democracy	adjective
{it}crinkling{/it} silks	verb
the economy {wi}veered{/wi} sharply downward	verb
little cabins {it}straggling{/it} off into the woods	verb
a {wi}desolate{/wi} abandoned town	adjective
a {wi}desolate{/wi} widow	adjective
a {it}long-lost{/it} masterpiece that has recently been rediscovered	adjective
He embraced his old friend like a {it}long-lost{/it} brother.	adjective
They did not believe his {wi}grandiose{/wi} claims.	adjective
had {wi}grandiose{/wi} plans for the city	adjective
a {wi}stiff{/wi} collar	adjective
{it}repelled{/it} the insinuation	verb
a {it}wall-mounted{/it} television set	adjective
{wi}well{/wi}-{wi}fed{/wi} pets	adjective
" … having children who are {wi}well{/wi}-{wi}fed{/wi} and not hungry makes a difference in their individual performance … "	adjective
a child needing human {wi}warmth{/wi} and family life	noun
an {wi}undemanding{/wi} job	adjective
an {wi}undemanding{/wi} boss	adjective
a tolerant, {wi}uncensorious{/wi} man	adjective
… she observed and wrote with the {wi}uncensorious{/wi} eyes of a worldly woman who is not affronted by the tangled messes human beings get themselves into.	adjective
the gradually {wi}encroaching{/wi} sea	verb
{wi}peaked{/wi} lapels	adjective
a {wi}peaked{/wi} hill	adjective
pressure upon educational administrators to {wi}withdraw{/wi} academic credit	verb
{it}withdrew{/it} his name from the list of nominees	verb
a {wi}self-contained{/wi} machine	adjective
a {wi}self-contained{/wi} program of study	adjective
the {wi}soft{/wi} influences of home	adjective
a {wi}soft{/wi} job	adjective
a paperback {wi}edition{/wi}	noun
this year's {wi}edition{/wi} of the annual charity ball	noun
the German {wi}edition{/wi}	noun
the {wi}imperious{/wi} problems of the new age	adjective
{wi}obstinate{/wi} resistance to change	adjective
{wi}obstinate{/wi} fever	adjective
a {wi}solid{/wi} ball of rubber	adjective
a {wi}solid{/wi} configuration	adjective
the suspect was {wi}uncooperative{/wi} with investigators	adjective
struggled with an {wi}uncooperative{/wi} corkscrew	adjective
an {wi}uncooperative{/wi} witness	adjective
{wi}commanded{/wi} adherence to the rules	verb
{it}buried{/it} their pet rabbit in the backyard	verb
a dog {it}burying{/it} a bone	verb
was {it}buried{/it} with full military honors	verb
a ship {it}surging{/it} in heavy seas	verb
the sea was {it}surging{/it}	verb
an {wi}infusion{/wi} of new ideas	noun
herbal {wi}infusions{/wi}	noun
has a {wi}mild{/wi} disposition	adjective
suddenly {wi}lurched{/wi} forward	verb
has {wi}lurched{/wi} from crisis to crisis	verb
{wi}stretched{/wi} out her arms	verb
was hustled into a … motorcar and {wi}spirited{/wi} off to the country	verb
hope and apprehension of feasibleness {wi}spirits{/wi} all industry	verb
our spirits were at a low {wi}ebb{/wi}	noun
a {wi}compassionate{/wi} friend	adjective
a {wi}compassionate{/wi} smile	adjective
{wi}flaring{/wi} nostrils	adjective
a {wi}penetrating{/wi} shriek	adjective
{wi}penetrating{/wi} insights into life	adjective
a {wi}bewitching{/wi} smile	adjective
her {wi}bewitching{/wi} eyes	adjective
the building {it}trembled{/it} from the blast	verb
a {wi}slight{/wi} chance	adjective
the {wi}climax{/wi} of a distinguished career	noun
handles the company's public {wi}affairs{/wi}	noun
an expert in foreign {wi}affairs{/wi}	noun
doesn't recall {wi}dreaming{/wi} last night	verb
{wi}dreaming{/wi} of a better future	verb
{wi}dream{/wi} of departed loved ones	verb
{wi}magical{/wi} powers	adjective
a {wi}magical{/wi} transformation	adjective
a story set in a {wi}magical{/wi} world	adjective
a {wi}strident{/wi} voice	adjective
{wi}strident{/wi} slogans	adjective
a {wi}crude{/wi} stereotype	adjective
{wi}crude{/wi} oil	adjective
{wi}crude{/wi} tools	adjective
{wi}sleek{/wi} dark hair	adjective
a TV {wi}antenna{/wi}	noun
{wi}boasting{/wi} about her accomplishments	verb
refusing to {wi}bow{/wi} to the inevitable	verb
{it}Bow{/it} before the king.	verb
{wi}bowed{/wi} to the champion	verb
a {wi}wraparound{/wi} skirt	adjective
{wi}sleek{/wi} dark hair	adjective
the regiment was fed and {wi}caressed{/wi} at station after station	verb
She {wi}caressed{/wi} the baby's cheek.	verb
chocolate cake with a {wi}luscious{/wi} whipped cream topping	adjective
a {wi}luscious{/wi} actress	adjective
{wi}bestowed{/wi} his spare time on study	verb
… {wi}bestowed{/wi} in her car … by the chauffeur.	verb
{wi}bright{/wi} lights	adjective
{wi}brightest{/wi} star of the opera	adjective
{wi}bright{/wi} eyes	adjective
{wi}dim{/wi} stars	adjective
a {wi}dim{/wi} outline	adjective
a {wi}dim{/wi} lamp	adjective
{wi}conquer{/wi} territory	verb
{wi}conquered{/wi} the enemy	verb
{wi}confront{/wi} an enemy	verb
{wi}confront{/wi} a reader with statistics	verb
The mayor was {wi}confronted{/wi} by a group of protesters.	verb
{wi}unwinding{/wi} the labryinth and bringing the hero out	verb
his … holster {it}jogging{/it} against his hip	verb
a {wi}private{/wi} park	adjective
{wi}shed{/wi} her inhibitions	verb
the company {wi}shed{/wi} 100 jobs	verb
a cold {wi}blast{/wi} of air	noun
the {wi}blast{/wi} of the shofar on Rosh Hashanah	noun
as {wi}helpless{/wi} as a flock of shepherdless sheep	adjective
the crowd looked on in {wi}helpless{/wi} horror	adjective
{wi}bypass{/wi} a congested area	verb
think carefully before {wi}answering{/wi}	verb
{wi}answer{/wi} for a debt	verb
a lane marked off by {wi}dashed{/wi} lines	adjective
{ldquo}How shall we cross the river?{rdquo} asked Dorothy. {ldquo}That is easily done,{rdquo} replied the Scarecrow. {ldquo}The Tin Woodman must build us a {wi}raft{/wi}, so we can float to the other side.{rdquo} So the Woodman took his axe and began to chop down small trees to make a {wi}raft{/wi} …	noun
{wi}rafts{/wi} of kelp	noun
Finally, the three astronauts, wearing their isolation garments, clambered out of the spacecraft into a rubber {wi}raft{/wi}.	noun
… has made a living poling a {wi}raft{/wi} on the Suchiate for two decades …	noun
{wi}mists{/wi} of antiquity	noun
{wi}glazed{/wi} pottery	adjective
{wi}glazed{/wi} eyes	adjective
{wi}glazed{/wi} fish	adjective
slipped and fell on his {wi}butt{/wi}	noun
{wi}laces{/wi} her fingers behind her head	verb
stumbled, then {wi}recovered{/wi} himself	verb
Special ships clear {wi}passages{/wi} through the ice.	noun
the {wi}passage{/wi} of food through the digestive system	noun
nasal {wi}passages{/wi}	noun
trapping travelers in an airless {wi}limbo{/wi}	noun
beyond {wi}retrieval{/wi}	noun
a dictator who {wi}banishes{/wi} anyone who opposes him	verb
He was {wi}banished{/wi} from court.	verb
{wi}fold{/wi} a letter	verb
{wi}fold{/wi} a tent	verb
He {wi}communicated{/wi} his dissatisfaction to the staff.	verb
{wi}communicate{/wi} a story	verb
Some diseases are easily {wi}communicated{/wi}.	verb
She {wi}communicated{/wi} her ideas to the group.	verb
{wi}concoct{/wi} a recipe	verb
{wi}concoct{/wi} an explanation	verb
{wi}concocted{/wi} a tropical fruit smoothie	verb
The dark clouds were considered a bad {wi}omen{/wi}.	noun
{wi}advance{/wi} a cause	verb
{wi}advance{/wi} a pawn	verb
{wi}pursue{/wi} a goal	verb
was beyond {wi}reproach{/wi}	noun
The couple said they get … updates and pictures from all the children they've {wi}fostered{/wi}.	verb
policies that {wi}foster{/wi} cooperation	verb
They {it}assembled{/it} a team of experts to solve the problem.	verb
{wi}assemble{/wi} a new bicycle	verb
blood {wi}circulates{/wi} through the body	verb
{wi}conduct{/wi} a class	verb
{wi}conduct{/wi} a class	verb
{wi}conduct{/wi} an opera	verb
{wi}conduct{/wi} an experiment	verb
{wi}conducted{/wi} herself in a professional manner	verb
{wi}conduct{/wi} a business	verb
His wit is his chief {wi}asset{/wi}.	noun
a {wi}consuming{/wi} interest	adjective
{wi}assume{/wi} responsibility	verb
{wi}assume{/wi} control	verb
{wi}join{/wi} two blocks of wood with glue	verb
two people {wi}joined{/wi} in marriage	verb
{wi}depress{/wi} a typewriter key	verb
letting cheese {wi}age{/wi}	verb
{it}retired{/it} to her room	verb
Imbalances in any area of this soft tissue, as well as {wi}inflexible{/wi} or weak hip muscles, can pull the kneecap off track …	adjective
Imbalances in any area of this soft tissue, as well as {wi}inflexible{/wi} or weak hip muscles, can pull the kneecap off track …	adjective
took an {wi}inflexible{/wi} stance	adjective
… he pulled out of the talks, saying administration officials were being {wi}inflexible{/wi}	adjective
{wi}underused{/wi} land	adjective
an {wi}underused{/wi} actress	adjective
a {wi}flowing{/wi} river	adjective
{wi}flowing{/wi} handwriting	adjective
{wi}examine{/wi} a prisoner	verb
… a richly {wi}backgrounded{/wi} study of a silent movie star …	verb
Graham peoples her novel with genuine, endearing characters and keeps the grisly murders tactfully {wi}backgrounded{/wi} …	verb
a well-{it}coordinated{/it} athlete	adjective
{wi}generating{/wi} profits/growth	verb
{wi}generating{/wi} profits/growth	verb
these stories … {wi}generate{/wi} a good deal of psychological suspense	verb
{wi}feared{/wi} enemies	adjective
the most {wi}feared{/wi} teacher in school	adjective
lowering the tax {wi}burden{/wi} on the middle class	noun
dropped his {wi}burden{/wi} of firewood	noun
a heavy {wi}burden{/wi} of guilt	noun
a tape with adhesive {wi}backing{/wi}	noun
financial {wi}backing{/wi}	noun
… he plans to reapply in the spring, when his patio permit is up for {wi}reapplication{/wi}.	noun
There are some sunscreens designed to be water/sweat proof; typically those products still recommend {wi}reapplication{/wi} every 40-80 minutes.	noun
the sugar {wi}melted{/wi} in the coffee	verb
an economy {it}crippled{/it} by inflation	verb
hostilities {wi}smoldered{/wi} for years	verb
{it}outlived{/it} most of his friends	verb
universities … {wi}outlive{/wi} many political and social changes	verb
{wi}outlive{/wi} its usefulness	verb
a {wi}flourishing{/wi} business	verb
He liked to {wi}display{/wi} his extensive knowledge of Greek mythology.	verb
He liked to {wi}display{/wi} his extensive knowledge of Greek mythology.	verb
{wi}displayed{/wi} an interest in music	verb
She {wi}displayed{/wi} no emotion upon hearing the news.	verb
The gallery {wi}displays{/wi} the work of local artists.	verb
… a … shop window {wi}displaying{/wi} shimmering silk scarves …	verb
It also comes with a wooden wall mount so you can proudly {wi}display{/wi} it in your living room.	verb
{wi}launched{/wi} an arrow at a target	verb
The historical society serves as the {wi}guardian{/wi} of the town's traditions.	noun
her honesty {wi}impressed{/wi} us	verb
stocks {wi}soared{/wi}	verb
a loose {wi}connection{/wi} in the wiring	noun
water {wi}disintegrates{/wi} the limestone	verb
The lies {wi}disintegrated{/wi} their marriage.	verb
the troops {wi}embarked{/wi} at noon	verb
{wi}embarked{/wi} on a new career	verb
hibernating animals {wi}reemerging{/wi} after the winter	verb
… old habits and patterns {wi}reemerge{/wi} …	verb
the {wi}friction{/wi} of sandpaper on wood	noun
{wi}friction{/wi} between neighbors	noun
a {wi}ringing{/wi} baritone	adjective
a {wi}ringing{/wi} condemnation of immorality	adjective
a {wi}mutinous{/wi} crew	adjective
{wi}mutinous{/wi} threats	adjective
{wi}regrets{/wi} his mistakes	verb
an {wi}elevated{/wi} highway	adjective
{wi}elevated{/wi} conversation	adjective
a {wi}solid{/wi} ball of rubber	adjective
a {wi}solid{/wi} configuration	adjective
pressure upon educational administrators to {wi}withdraw{/wi} academic credit	verb
{it}withdrew{/it} his name from the list of nominees	verb
I only saw him from the {wi}back{/wi}.	noun
{it}stifled{/it} our anger	verb
a {wi}feeble{/wi} old man	adjective
a {wi}feeble{/wi} argument	adjective
{wi}ratify{/wi} a treaty	verb
{wi}furnished{/wi} food and shelter for the refugees	verb
The inn is beautifully {wi}furnished{/wi}.	verb
{wi}abandon{/wi} ship	verb
{wi}grasping{/wi} for support	verb
the {wi}essentials{/wi} of astronomy	noun
removing {wi}obstructions{/wi} that block the path	noun
an intestinal {wi}obstruction{/wi}	noun
glad to have gotten through the divorce proceedings without any visible signs of {wi}hostility{/wi}	noun
there was tension, there was {wi}hostility{/wi} and envy in the air	noun
showed open {wi}hostility{/wi} toward outsiders	noun
The game requires excellent hand-eye {wi}coordination{/wi}.	noun
Payment is {wi}contingent{/wi} on fulfillment of certain conditions.	adjective
a plan {wi}contingent{/wi} on the weather	adjective
{wi}hand{/wi} a letter to her	verb
{wi}hand{/wi} a lady into a bus	verb
a good teacher {wi}predisposes{/wi} children to learn	verb
malnutrition {wi}predisposes{/wi} one to disease	verb
the point at which the two surfaces {wi}contact{/wi}	verb
{wi}poured{/wi} money into the project	verb
{wi}cater{/wi} for a large party	verb
{wi}catering{/wi} to middle-class tastes	verb
a {wi}commentary{/wi} on Dante's {it}Divine Comedy{/it}	noun
The {wi}orbit{/wi} encloses and protects the eye and its appendages.	noun
an {wi}enterprising{/wi} young reporter	adjective
They have been {wi}avoiding{/wi} me.	verb
{wi}avoid{/wi} a plea	verb
a high-{it}yielding{/it} wheat	adjective
{wi}scalar{/wi} chain of authority	adjective
{wi}scalar{/wi} quantity	adjective
{wi}scalar{/wi} cells	adjective
{wi}assigned{/wi} them to light duty	verb
{wi}curl{/wi} one's hair	verb
{wi}curled{/wi} his lip in a sneer	verb
How can I {wi}help{/wi} you?	verb
bright curtains will {wi}help{/wi} the room	verb
He {wi}helps{/wi} the children with their homework.	verb
{wi}manage{/wi} a bond issue	verb
{wi}manages{/wi} a baseball team	verb
an agency that {wi}manages{/wi} entertainers	verb
{wi}ban{/wi} discrimination	verb
{it}banned{/it} from the U.N.	verb
{wi}ban{/wi} a book	verb
Is smoking {it}banned{/it} in all public buildings?	verb
is said to {wi}derive{/wi} its name from a Native American word meaning "wild onion"	verb
what was {it}derived{/it} from their observations	verb
{wi}roughly{/wi} 20 percent	adverb
The sun {wi}beamed{/wi} its light through the window.	verb
The house was {wi}beamed{/wi} with heavy timbers.	verb
{wi}borrow{/wi} a book from the library	verb
{wi}borrow{/wi} a metaphor from Shakespeare	verb
{wi}borrowed{/wi} a dollar	verb
a {wi}canceled{/wi} check	verb
{wi}cancel{/wi} a football game	verb
measures of traffic {wi}density{/wi}	noun
the {wi}density{/wi} of the cake	noun
a {wi}canceled{/wi} check	verb
{wi}cancel{/wi} a football game	verb
… I caught him boasting … about how popular he had become. Oh well, he could have been joking only, but to me I find it very {wi}assuming{/wi} of him.	adjective
{ldquo}When there are conversations centering around sexual assault, they tend to be very {wi}assuming{/wi} of heterosexual dynamics.{rdquo}	adjective
{wi}risked{/wi} her life	verb
{wi}risked{/wi} breaking his neck	verb
ideas {wi}simmering{/wi} in the back of my mind	verb
the {wi}vanes{/wi} of a windmill	noun
well {wi}schooled{/wi} in languages	verb
The child was {wi}schooled{/wi} at great cost to her family.	verb
{wi}rugged{/wi} mountains	adjective
… misidentified as … a flying reptile, not a {wi}feathered{/wi} dinosaur …	adjective
He was a big man, and in his costume— … {wi}feathered{/wi} anklets, feathered gauntlets, beaded headband … —he seemed magnified in every dimension, almost a spirit-being.	adjective
referring to birds as "our {wi}feathered{/wi} friends"	adjective
{wi}coil{/wi} a rope	verb
{wi}coiled{/wi} herself up on the couch	verb
the sun {it}blazed{/it} overhead	verb
fields {it}blazing{/it} with flowers	verb
a decorative {wi}motif{/wi}	noun
Ms. Cisneros doesn't present too many nice guys here, and the perfidy of men is a {wi}motif{/wi} in several of the stories.	noun
"How {wi}queer{/wi} it seems," Alice said to herself, "to be going messages for a rabbit!"	adjective
The endless and numberless avenues of bewildering pine woods gave him a {wi}queer{/wi} feeling that he was driving through the countless corridors of a dream.	adjective
{wi}scan{/wi} poetry	verb
Teachers are {it}negotiating{/it} for higher salaries.	verb
{wi}dip{/wi} candles	verb
{it}dancing{/it} to our favorite song	verb
{it}dance{/it} for joy	verb
Shall we {wi}dance{/wi}?	verb
{wi}suppress{/wi} a riot	verb
{wi}apprehend{/wi} a thief	verb
She immediately {wi}apprehended{/wi} the problem.	verb
{wi}overexcited{/wi} children	adjective
{wi}overexcited{/wi} neurons	adjective
a {wi}grizzled{/wi} beard	adjective
a {wi}grizzled{/wi} veteran	adjective
wrote a hilarious {wi}parody{/wi} of a popular song	noun
a cheesy {wi}parody{/wi} of a classic western	noun
wrote a hilarious {wi}parody{/wi} of a popular song	noun
a cheesy {wi}parody{/wi} of a classic western	noun
Their hair was sleek, of a slightly other period, immaculate {wi}pageboys{/wi} and French twists.	noun
a mirror {wi}reflects{/wi} light	verb
the clouds were {wi}reflected{/wi} in the water	verb
a {wi}veiled{/wi} hat	adjective
{wi}veiled{/wi} threats	adjective
the seventeenth century lay in the {wi}penumbra{/wi} of the middle ages	noun
{wi}foxy{/wi} grapes	adjective
Group identity in {wi}oppressed{/wi} groups is always very strategic, always a calculation of advantage.	adjective
They are neither {wi}oppressed{/wi} minorities, whose needs have been etched into the nation's consciousness, nor members of the ruling elite, born with their hands on the reins of power.	adjective
{wi}shut{/wi} the lid	verb
{wi}shut{/wi} herself in her study	verb
hit by an {wi}avalanche{/wi} of paperwork	noun
{wi}somber{/wi} dignitaries	adjective
She {wi}aims{/wi} to win.	verb
{it}Aim{/it} carefully before shooting.	verb
Darting down the corridor …, she {wi}reappeared{/wi} moments later carrying glasses in filigreed silver holders …	verb
By year's end the insects have gone, only to {wi}reappear{/wi} briefly in May.	verb
{wi}variegated{/wi} leaves	adjective
a {wi}brave{/wi} soldier	adjective
{wi}brave{/wi} banners flying in the wind	adjective
a {wi}brave{/wi} smile	adjective
Storm clouds {wi}loomed{/wi} on the horizon.	verb
deficits {wi}loomed{/wi} large	verb
spoke in low {wi}tones{/wi}	noun
masculine {wi}tones{/wi}	noun
{wi}pabulum{/wi} for consideration and reflection	noun
Roots deliver {wi}pabulum{/wi} to the plant.	noun
a {wi}howling{/wi} storm	adjective
a {wi}howling{/wi} wilderness	adjective
{wi}swap{/wi} stories	verb
it is {wi}cold{/wi} outside today	adjective
a {wi}cold{/wi} stare	adjective
a {wi}cold{/wi} drafty attic	adjective
the music was a {wi}turnoff{/wi}	noun
{wi}hop{/wi} in the car	verb
{it}horny-{/it}handed	adjective
a {wi}horny{/wi} growth	adjective
protesters were {wi}chanting{/wi} outside	verb
What is there to {wi}cheer{/wi} about?	verb
{wi}extract{/wi} data	verb
designed to be a {wi}forgiving{/wi} tennis racquet	adjective
spokes attached to the {wi}hub{/wi} of the wheel	noun
The island is a major tourist {wi}hub{/wi}.	noun
{wi}stale{/wi} bread	adjective
a {wi}stale{/wi} routine	adjective
a {wi}tart{/wi} apple	adjective
a {wi}tart{/wi} rejoinder	adjective
{wi}wade{/wi} through the crowd	verb
The jury {it}absolved{/it} the defendants of their crimes.	verb
asked the priest to {wi}absolve{/wi} his sins	verb
Her youth does not {wi}absolve{/wi} her of responsibility for her actions.	verb
The pills made her {wi}drowsy{/wi}.	adjective
a {wi}drowsy{/wi} village	adjective
a {wi}creamy{/wi} consistency	adjective
cut costs to the {wi}bone{/wi}	noun
{ldquo}Give Me Liberty,{rdquo} the Milwaukee-made movie that received good notices at this year's Sundance Film Festival and the Cannes Film Festival, will come home for its U.S. {wi}theatrical{/wi} premiere, Aug. 22 at the Oriental Theatre.	adjective
a {wi}theatrical{/wi} costume	adjective
a {wi}theatrical{/wi} gesture	adjective
a {wi}theatrical{/wi} troupe	adjective
an actor with a flair for {wi}melodrama{/wi}	noun
The trial turned into a {wi}melodrama{/wi}.	noun
fumes {wi}leak{/wi} in	verb
confidential information {wi}leaked{/wi} out	verb
his stomach {wi}growled{/wi}	verb
a {wi}blossoming{/wi} talent	verb
They were {wi}doubtful{/wi} about the advantages of the new system.	adjective
of {wi}doubtful{/wi} repute	adjective
a vegetable {wi}plot{/wi}	noun
would not {wi}disclose{/wi} his salary	verb
… a new initiative targeting brothels and massage parlors {wi}fronting{/wi} for sex trafficking rings.	verb
a ten-acre plot {wi}fronting{/wi} on a lake	verb
{wi}irritated{/wi} eyes	adjective
doesn't recall {wi}dreaming{/wi} last night	verb
{wi}dreaming{/wi} of a better future	verb
{wi}dream{/wi} of departed loved ones	verb
hidden {wi}among{/wi} the trees	preposition
living {wi}among{/wi} artists	preposition
{wi}tie{/wi} a fishing fly	verb
{wi}tie{/wi} a fishing fly	verb
{wi}clear{/wi} the water by filtering	verb
the opportunity to {wi}clear{/wi} himself	verb
{wi}reopen{/wi} discussion	verb
a {wi}glamorous{/wi} actress	adjective
a {wi}glamorous{/wi} life	adjective
doesn't recall {wi}dreaming{/wi} last night	verb
{wi}dreaming{/wi} of a better future	verb
{wi}dream{/wi} of departed loved ones	verb
{wi}cram{/wi} a suitcase with clothes	verb
a novel {it}crammed{/it} with surprises	verb
a dog {it}chasing{/it} a rabbit	verb
{wi}sort{/wi} apples	verb
{wi}sort{/wi} mail	verb
a {wi}boiling{/wi} sea	adjective
the {wi}flight{/wi} of a bee	noun
{wi}flight{/wi} of an arrow	noun
{wi}swing{/wi} an ax	verb
the heat {wi}dampened{/wi} our spirits	verb
the shower barely {wi}dampened{/wi} the ground	verb
the {wi}legs{/wi} of a tripod	noun
{wi}positioned{/wi} the chairs around the room	verb
{wi}positioned{/wi} the company in the global market	verb
{wi}drive{/wi} cattle across the prairie	verb
{wi}drives{/wi} a hard bargain	verb
Americans {it}cringed{/it} … at the use of a term now regarded as a slur	verb
The terrified animal {it}cringed{/it} in the corner.	verb
Americans {it}cringed{/it} … at the use of a term now regarded as a slur	verb
The terrified animal {it}cringed{/it} in the corner.	verb
The {wi}addition{/wi} expanded the kitchen.	noun
The clerk was a recent {wi}addition{/wi} to the staff.	noun
{wi}adds{/wi} 60 acres to his land	verb
Do you have anything else to {wi}add{/wi} to the discussion?	verb
wine {wi}adds{/wi} a creative touch to cooking	verb
the healing {wi}miracles{/wi} described in the Gospels	noun
The bridge is a {wi}miracle{/wi} of engineering.	noun
These jeans don't {wi}fit{/wi} me anymore.	verb
{ldquo}My first impression of Joy was that her name {wi}fit{/wi} her perfectly. She radiated joy and calmness …{rdquo}	verb
the fox {it}trotted{/it} over the knoll	verb
Let's face it: The process of waiting for your hair to {wi}loc{/wi} can be both lengthy and frustrating.	verb
You can choose to let the hair {wi}loc{/wi} and then separate it. But you can also part the hair in advance to divide it into distinct sections.	verb
{wi}holds{/wi} a PhD	verb
{wi}holds{/wi} a PhD	verb
{wi}holds{/wi} property worth millions	verb
the bank {wi}holds{/wi} the title to the car	verb
the {wi}corruption{/wi} of computer files	noun
the {wi}corruption{/wi} of computer files	noun
media {wi}bashing{/wi}	verb
a proposal that {wi}smacks{/wi} of treason	verb
an economy {it}crippled{/it} by inflation	verb
a {wi}fabulous{/wi} view from the summit	adjective
{wi}fabulous{/wi} wealth	adjective
{wi}fabulous{/wi} dragons	adjective
